Love Al Di La 	__label__positive
I recommend this place to everyone .	__label__positive
Great food .	__label__positive
One of my favorite places in Brooklyn .	__label__positive
the sepia ) are fantastic and t he braised rab bit is amazing .	__label__positive
Overpriced and not tasty	__label__negative
The food here was mediocre at best .	__label__negative
It was totally overpriced- fish and chips was about $ 15 ... .	__label__negative
It was totally overpriced- fish and chips was about $ 15 ... .	__label__negative
Tasty Dog !	__label__positive
dog , and a conscious eco friendly  establishmen t .	__label__positive
One of the best hot dogs I have ever eaten .	__label__positive
Ca n't wait to go back .	__label__positive
The Cypriot restaurant has a lot going for it .	__label__positive
But the best pork souvlaki I ever had is the main thing	__label__positive
But the best pork souvlaki I ever had is the main thing	__label__positive
Run do n't walk .	__label__positive
Super YUMMY Pizza !	__label__positive
we discovered this really warm and inviting restaurant .	__label__positive
eggplant pizza , as well as their  pasta s !	__label__positive
We had half/half pizza , mine was eggplant and my friend	__label__positive
We had fun eating in there , we were there like around 3 a.m. in the morning !	__label__positive
Will comeback for sure , wish they have it here in LA..	__label__positive
Excellent food , although the  interio r could use some help .	__label__negative
The space kind of feels like an Alice in	__label__negative
just about $ 60 for a good  mea l , though : )	__label__positive
Great sake !	__label__positive
Reliable , Fresh  Sush i	__label__positive
Reliable , Fresh  Sush i	__label__positive
The sashimi is always fresh and the rolls are innovative and delicious .	__label__positive
Have never had a problem with service save a missing rice once .	__label__positive
 Delivery can be spot on or lacking depending	__label__negative
 Delivery guy sometimes get upset if you do n't	__label__negative
 Delivery guy sometimes get upset if you do n't	__label__negative
Best .  Sush i . Ever .	__label__positive
This place has ruined me for neighborhood sushi .	__label__positive
Creative , consistent , fresh .	__label__positive
Excellent sashimi , and the  millennium rol l is beyond delicious .	__label__positive
Not cheap but very yummy .	__label__positive
Love it .	__label__positive
Very , very nice	__label__positive
The place is a bit hidden away , but	__label__positive
not only is the food	__label__positive
Loved It	__label__positive
Loved It	__label__positive
We had a very nice time .	__label__positive
, the food was delicious and the  views of the cit y were great .	__label__positive
I 'd definitely go back again .	__label__positive
Great place to relax and enjoy your dinner	__label__positive
There is something about their atmosphere that makes me come back nearly every	__label__positive
 Place is open till late , no dress	__label__positive
Good food : my favorite is the  seafood spaghett i .	__label__positive
Highly recommended !	__label__positive
Excellent food for great prices	__label__positive
My husband and I have been sold on this from the first visit .	__label__positive
The wait staff is very courteous and accomodating .	__label__positive
richly rewarded when you savor the delicious  indo-chinese foo d .	__label__positive
There are no negatives to speak of .	__label__positive
the bestt !	__label__positive
my favorite place lol	__label__positive
i love their chicken pasta cant remember the name but is sooo	__label__positive
its alright	__label__neutral
im not necessarily fanatical about this place , but it was a fun time	__label__positive
 lobster was good , nothing spectacular .	__label__neutral
to go , not a five star  restaraun t .	__label__neutral
Way below average	__label__negative
I think the pizza is so overrated and was under cooked	__label__negative
Had no flavor and the staff is rude and not attentive .	__label__negative
Would NEVER go back	__label__negative
I love this place 	__label__positive
I was n't here for the pizza so I ca n't comment on that yet but what I had was very good .	__label__positive
The service was quick and friendly .	__label__positive
Everyone was smiling so that made me feel welcome .	__label__positive
I thought the restaurant was nice and clean .	__label__positive
I ordered the vitello alla marsala and I was pretty impressed .	__label__positive
The veal and the mushrooms were cooked perfectly .	__label__positive
The potato balls were not dry at all ... in	__label__positive
The only downside ... they only take cash which is OK if you know about it ahead of time .	__label__negative
I 'll be back for sure .	__label__positive
WORST PLACE ON SMITH STREET IN BROOKLYN	__label__negative
the food was not fresh or war m , waitre sses were busy flirting with men at	__label__negative
I would never recommend this place to anybody even for a casual dinner	__label__negative
awesome	__label__positive
the food is always fresh ...	__label__positive
overpriced japanese food with mediocre service 	__label__neutral
Went here on sat 1/26 and was disappointed .	__label__negative
 Chicken teriyaki had tomato or pimentos on top ?	__label__negative
 food was luke warm .	__label__negative
The waitress was not attentive at all .	__label__negative
I was looking for banana tempura for dessert and they dont have .	__label__negative
I was looking for banana tempura for dessert and they dont have .	__label__negative
Not because you are ` ` The Four Seaso ns '' ... – you are allowed	__label__negative
as service , however , I lef t The Four Seaso ns very dissappointed .	__label__negative
I do not think dinner in Manhattan should cost $ 400.00 where	__label__negative
 Red Dragon Roll - my favorite thing to eat ,	__label__positive
Just go to Yamato and order the Red Dragon Roll .	__label__positive
If you do n't like it , I do n't know what to tell you .	__label__positive
The Seafood Dynamite is also otherworldly .	__label__positive
I 'm not even going to bother to describe it ; it speaks for itself .	__label__positive
Favorite Sushi in NYC	__label__positive
Favorite Sushi in NYC	__label__positive
the sushi is consistently good , th e servi ce is pleasant , effective and unassuming	__label__positive
In the summer months , the  back garden are a is really nice .	__label__positive
that serves up more inventive yet delicious japanese food .	__label__positive
The Dancing , White River and Millenium roll s are musts .	__label__positive
SO GOOD	__label__positive
OF THE WEEK REALLY LOL LOVE THIS PLACE ... )	__label__positive
Gross food – Wow-	__label__negative
the last time I had such gross  foo d in New York .	__label__negative
My quesadilla tasted like it had been made by	__label__negative
$ 11 for a plate of bland  guacamol e ?	__label__negative
$ 11 for a plate of bland  guacamol e ?	__label__negative
Do n't get me started on the  margarita s , either .	__label__negative
Mine tasted like the bartender had forgotten to add the tequila .	__label__negative
Mine tasted like the bartender had forgotten to add the tequila .	__label__negative
Save your money and your time and go somewhere else .	__label__negative
was so moved by how bad th is pl ace was , I felt it was	__label__negative
Great Indian Food !	__label__positive
Great Indian Food !	__label__positive
When I got there the place was packed but they made sure to seat me quickly .	__label__positive
The food was good , the  plac e was clean and affordable .	__label__positive
which is a great sign for an indian place !	__label__positive
This is one of my favorite spot , very relaxing the food is great all the times , celebrated my engagement and my wedding here , it was very well organized .	__label__positive
The staff is very good .	__label__positive
Love their drink menu .	__label__positive
I highly recommend this beautiful place .	__label__positive
Nice for one time special occasion .	__label__positive
Nice for one time special occasion .	__label__positive
They honored reservation on Sunday afternoon very well .	__label__positive
They honored reservation on Sunday afternoon very well .	__label__positive
the table but were not told the Voss bottles of water were $ 8 a piece .	__label__negative
 Food was OK .	__label__neutral
Nice view of river and NYC .	__label__positive
I come here enjoy very much with husband .	__label__positive
Remind me of home .	__label__positive
Great survice 	__label__positive
MMMMMMMMMmmmmmm so delicious	__label__positive
A beautifully designed dreamy Egyptian restaurant that gets sceney at night .	__label__positive
Watch the talented belly dancers as you enjoy delicious baba ganoush that	__label__positive
Oh , and there ' s hook ah .	__label__positive
 Raymond the bartender rocks !	__label__positive
 Pacifico is a great place to casually hang	__label__positive
are great , especially when made by  Raymon d .	__label__positive
The omlette for brunch is great ...	__label__positive
the spinach is fresh , definately not frozen ...	__label__positive
pacifico is yummy , as are the  wings with chimmichur i .	__label__positive
A weakness is the chicken in the salads .	__label__negative
It 's just average , just shredded , no seasoning on it .	__label__negative
personally was n't a fan of th e portobello and asparagus mo le .	__label__negative
at a good price , with friendl y peop le .	__label__positive
Best Indian Restaurant in the City	__label__positive
Decor needs to be upgraded but the food is amazing !	__label__positive
spot makes what many consider the best gyros in New York .	__label__positive
spot makes what many consider the best gyros in New York .	__label__positive
, and made of much higher qua lity ingred ients that might otherwise be expected .	__label__positive
Cypriot dishes are excellent , but the  gyr o is the reason to come --	__label__positive
Best restaurant in Brooklyn	__label__positive
The best !	__label__positive
Great food , amazing service , thi s pla ce is a class act .	__label__positive
The veal was incredible last night .	__label__positive
Fresh , mind blowing flavors .	__label__positive
This place is a must visit !	__label__positive
This place is a must visit !	__label__positive
This place is a must visit !	__label__positive
Delicious , creative and fun .	__label__positive
Got a date ? Go here !	__label__positive
Every time I have a special occasion with my boyfriend I have a hard time going anywhere else .	__label__positive
It is so romantic .	__label__positive
Its dark , and cozy.. there is always jazz music playing when we go .	__label__positive
Most of the booths allow you to sit next to eachother	__label__positive
The food is all shared so we get to	__label__positive
the only exceptions being the occasional too-authentic-for- me d ish ( I 'm a daring eater	__label__negative
Once you try it for a special occasion beware.. you ca n't stop !	__label__positive
You 'll be ther for every anniversary , birthday , valentines day ...	__label__positive
For a Fabulous Wedding !	__label__positive
My daughter 's wedding reception at  Water 's Ed ge received the highest compliments from our	__label__positive
absolutely incomparable views ) and the fabulou s fo od !	__label__positive
 Service was wonderful ;	__label__positive
everyone was cheerfully cooperative and helpful .	__label__positive
 Paul , the maitre d ' , was	__label__positive
Thank you everyone at Water 's Edg e .	__label__positive
Thank you everyone at Water 's Edg e .	__label__positive
would NOT go back .	__label__negative
Service ok but unfriendly , filth y bathro om .	__label__negative
The high prices you 're going to pay is for the view not for the food .	__label__negative
The bar drinks were Eh , ok to say the	__label__negative
The stuff tilapia was horrid ... tasted like cardboard .	__label__negative
We thought the dessert would be better , Wrong !	__label__negative
$ 170 down the toilet ...	__label__negative
oh speaking of bathroom , the mens bathroom was disgusting .	__label__negative
The floor was wet , the trash can filled with hand towels n all over the floor , no soap , and no hand towels left .	__label__negative
The floor was wet , the trash can filled with hand towels n all over the floor , no soap , and no hand towels left .	__label__negative
Good Experience	__label__positive
Good Experience	__label__positive
wine list was extensive - though the staff did not seem knowledgeable about wine pairings	__label__negative
and cold - and the `` free  '' appetizer of ol ives was disappointing .	__label__neutral
However , our  main cours e was wonderful .	__label__positive
had fish and my husband had the filet - both of which exceeded our expectations	__label__positive
good - but , once again , the s taff was unable to provide appropriate drink	__label__negative
When we inquired about ports - the waitress listed off several but did not know	__label__negative
for the price and prestige of this location .	__label__neutral
beautiful restaurant - but I hope the  staf f pays more attention to the little	__label__negative
short and sweet – seating is great : it 's romantic ,	__label__positive
The boths are not as small as some of	__label__positive
I barely understood 1 word when t he wai ter took our order .	__label__negative
The food was ok and fair nothing to go	__label__neutral
The food was ok and fair nothing to go	__label__neutral
looks of the place exceeds the actual meals .	__label__negative
paying for is the restaurant not the food .	__label__negative
Will prob . not return but it is a great dinning experience to try atleast once .	__label__positive
Impressed ...	__label__positive
Subtle food and service 	__label__positive
is exactly the type of service and food I enjoy .	__label__positive
Servers are all different ,  Gre g is my favorite .	__label__positive
humor but it 's refreshing to have a serv er who has personality , professionalism ,	__label__positive
first place I 've been that a  runne r remembers my order ... hope he	__label__positive
across the board for both food and bev .	__label__positive
to eat and like my courses ,  server s are patient and never rush courses	__label__positive
to eat and like my courses ,  server s are patient and never rush courses	__label__positive
fresh dogs but best of all endless toppings ! ! !	__label__positive
this place had ALL the trimmings and i mean all .	__label__positive
peppers , onions , relish , chilli , cheeses , you NAME it .	__label__positive
amazing fun for hot dog lovers of all ages PLEASE do yourself	__label__positive
BEST DINING EXPERIENCE IN THE WEST VILLAGE !	__label__positive
Stepping into Casa La Femme last night was a true experience unlike	__label__positive
Highly impressed from the decor to the food to the hospitality to the great night I had !	__label__positive
The have a great cocktail with Citrus Vodka and lemon and lime juice and mint leaves that is to die for !	__label__positive
Food took some time to prepare , all worth waiting for .	__label__neutral
We were drawn into the belly dancing show that captivated the crowd .	__label__positive
never write on these sites but this restaurant is def worth commending !	__label__positive
Great find in the West Village !	__label__positive
Maggot in the food !	__label__negative
Maggot in the food !	__label__negative
was very nice , but when th e fo od came , it was average .	__label__neutral
that 's when I found a maggot in mushroom sa uce at the bottom .	__label__negative
I showed it to the manager , and he smilingly apologized and brought	__label__negative
When the bill came , nothing was comped , so I told the manager very politely that we were willing to pay for the wine , but I did n't think I should have to pay for food with a maggot in it .	__label__negative
When the bill came , nothing was comped , so I told the manager very politely that we were willing to pay for the wine , but I did n't think I should have to pay for food with a maggot in it .	__label__negative
The manager finally said he would comp the two	__label__negative
We paid and left because we did n't feel like arguing any more .	__label__negative
be able to get into well prepared  foo d .	__label__negative
reason for such a lack of intelligent  customer servic e .	__label__negative
reason for such a lack of intelligent  customer servic e .	__label__negative
Unhygienic	__label__negative
I do not recommend .	__label__negative
I do not recommend .	__label__negative
I got hair in my food 2 times of then !	__label__negative
Great place , great value .	__label__positive
The food is flavorful , plentiful and reasonably priced	__label__positive
The atmosphere is relaxed and casual .	__label__positive
It 's a great  plac e to order from or sit-in .	__label__positive
Awesome	__label__positive
Inexpensive , unassuming , great time !	__label__positive
 Sushi experience was unbelievable with my fiance .	__label__positive
Try it !	__label__positive
Very pleased	__label__positive
Good creative rolls !	__label__positive
 Yamato is an excellent place to go if	__label__positive
They have great rolls , the  triple color and norwegetan roll s , are awesome and filling .	__label__positive
One special roll and one regular roll is enough to fill you up ,	__label__positive
dessert , as well as a great  green tea tempur a .	__label__positive
The appetizers are also delicious !	__label__positive
Amazing food .	__label__positive
Mazing interior .	__label__negative
Great food !	__label__positive
I 've had my fair share of  modern Japanes e and this spot delivers .	__label__positive
to make up for with a crazy  scheme of mirror s .	__label__negative
If you 're into being lost when you 're just five feet from your table then hey , that 's a good thing .	__label__negative
Despite the confusing mirrors this will likely be my go-to for	__label__negative
Despite the confusing mirrors this will likely be my go-to for	__label__negative
 Indo Chinese food , pretty good ...	__label__positive
a very fancy place but very good Chinese style Indian food .	__label__positive
quite oily and very spicy , espeically the Chilli Chi cken .	__label__negative
she ( being Indian ) feels t he f ood can be somewhat over the top	__label__negative
Still we keep going back : )	__label__positive
I was speechless by the horrible food .	__label__negative
dinner at the restaurant , and the  foo d was majorly disappointing .	__label__negative
dinner at the restaurant , and the  foo d was majorly disappointing .	__label__negative
Rather than preparing vegetarian dish , the chef presented me with a	__label__negative
I was so stunned , and I left the dinner hungry and majorly disappointing .	__label__negative
This place survives on reputation alone .	__label__negative
I will NEVER return .	__label__negative
Best In ALL of NYC	__label__positive
This is the MOST wonderful restaurant in all of New York City ,	__label__positive
out the most tasty , most delicious  foo d and kept it that way ...	__label__positive
never a bad meal , never ba d servi ce ...	__label__positive
never a bad meal , never ba d servi ce ...	__label__positive
you should travel from the Bronx to try it ...	__label__positive
list , great service in a grea t neighborho od ...	__label__positive
so delicious ! ! ! ! ! !	__label__positive
 Patsy 's Pizz a = true love	__label__positive
Hands down the best pizza on the planet .	__label__positive
Hands down the best pizza on the planet .	__label__positive
In about 12 minutes , the thing is gone .	__label__positive
In about 12 minutes , the thing is gone .	__label__positive
great hot dogs ..	__label__positive
the hot dogs were juicy and tender inside and had	__label__positive
great toppings definitely a place you need to check out for late	__label__positive
great taste	__label__positive
Great , original taste .	__label__positive
For me dishes a little oily , but overall dining experience good .	__label__positive
Helpful service and average price per dish $ 10 .	__label__neutral
only thing that strikes you is the decor ? ( not very pleasant ) .	__label__negative
great food 	__label__positive
This place has great indian chinese food .	__label__positive
The flavors are amazing and the value is phenomenal .	__label__positive
Be prepared to wait , because the  plac e is pretty tiny .	__label__negative
Also , they do not take credit card so come with cash !	__label__neutral
the place is not beautiful , the  foo d speaks for itself .	__label__positive
Best Indian Chinese in the city , by far !	__label__positive
AMAZING MY FAVORITE ! ! !	__label__positive
AMAZING MY FAVORITE ! ! !	__label__positive
I came across Village Underground by accident , now I go there	__label__positive
The martinis are amazing and very fairly priced .	__label__positive
IS AMAZING , i 've had differen t waite rs and they were all nice ,	__label__positive
The DJ is awesome , I have been there for my birthday and a bunch of other times with friends and I keep going back .	__label__positive
You can get a table without a reservation if you get there early I they do n't make you by bottles .	__label__positive
Which lets face it ... .at times it 's a good thing .	__label__positive
In the end you end up with a fair tab and NOTHING BUT A GREAT TIME ! ! !	__label__positive
Highly recommended !	__label__positive
One of the best , if not THE best , restaurants in Park Slope ( and NY in general )	__label__positive
Everything on the menu is great .	__label__positive
This establishment is the real deal .	__label__positive
Wish NY had more of these kind of places : intimate , superb food , homey , top notch all the way around , certainly worth the wait .	__label__positive
Wish NY had more of these kind of places : intimate , superb food , homey , top notch all the way around , certainly worth the wait .	__label__positive
Wish NY had more of these kind of places : intimate , superb food , homey , top notch all the way around , certainly worth the wait .	__label__positive
But $ 500 for a  dinner for tw o that did n't include Wine ?	__label__negative
But $ 500 for a  dinner for tw o that did n't include Wine ?	__label__negative
Look , the  appetizer s were really good .	__label__positive
The entree was also very good .	__label__positive
Ca n't argue about that , but they are clearly over priced .	__label__negative
What you are paying for is the environment and the name .	__label__negative
Yes , the  plac e is classy and beautiful , but	__label__negative
Yes , the  plac e is classy and beautiful , but	__label__negative
Yes , the  plac e is classy and beautiful , but	__label__negative
Yes , the  plac e is classy and beautiful , but	__label__negative
Which of course is not real Kobe but Wagyu beef .	__label__negative
Surprised that a place of this caliber would advertise it as Kobe .	__label__negative
Surprised that a place of this caliber would advertise it as Kobe .	__label__negative
Surprised that a place of this caliber would advertise it as Kobe .	__label__negative
 Vanison was good but not amazing .	__label__neutral
 Bison was quite excellent however .	__label__positive
 Dessert : pure disaster .	__label__negative
Just not good at all .	__label__negative
Some Pineapple covered in a glaze of some kind and some pear tart thing Not impressive at all .	__label__negative
I read reviews that called the restaurant too expensive and I thought to myself	__label__negative
I read reviews that called the restaurant too expensive and I thought to myself	__label__negative
 The Four Seasons has history and it is a sort	__label__negative
I wanted to go there to see if it was worth it and sadly , curiousity got the best of me and I paid dearly for it .	__label__negative
food was great ( except for th e dessser ts ) .	__label__negative
The environment is very upscale and you will see a lot of rich guys with trophy wives or just highly paid escorts .	__label__neutral
If you are going for the food , it will not be worth it	__label__negative
If you are going for the food , it will not be worth it	__label__negative
they would make up for it with service , sadly , no .	__label__negative
Service was just ok , it is not what you 'd expect for $ 500 .	__label__negative
Terrible Waste of money.. scammers	__label__negative
I agree that dining at Casa La Femme is like no other dining experience !	__label__negative
I agree that dining at Casa La Femme is like no other dining experience !	__label__negative
I am actually offended to have spent so much money on such a bad experience .	__label__negative
literally just got back home after visiting Casa La Femme and was so offended by my visit	__label__negative
literally just got back home after visiting Casa La Femme and was so offended by my visit	__label__negative
Our visit their to say the least , was an unpleasant and costly experience !	__label__negative
And even more so unpleasant because it was so costly for such an unpleasant experience .	__label__negative
can not complain too much about the wait for a table .	__label__neutral
Although we were told 10-15 minutes and it was more like 45 minutes .	__label__negative
We were ushered to the bar to wait momentarily and upon arrival were so excited .	__label__positive
The place is beautiful !	__label__positive
The hostess was very pleasant .	__label__positive
However , our $ 1 4 drin ks were were horrible !	__label__negative
Once we finally got a table , despite indicating we wanted an alla carte menu we were pushed into a table that was only price fixed !	__label__negative
Once we finally got a table , despite indicating we wanted an alla carte menu we were pushed into a table that was only price fixed !	__label__negative
Our experience did not ever get any better .	__label__negative
For each course we waited over 1/2 hour to 45 minutes and were never offered a drink .	__label__negative
asked for Hooka six times and the waiter kept telling us one minute and never	__label__negative
4th time i asked again and the waiter than said after our dinner .	__label__negative
We asked for beverages and never received them .	__label__negative
We asked for sides which the waiter than admitted that he forgot to put	__label__negative
My chicken was inedible as there were so many	__label__negative
not expect this for a $ 55  dinne r .	__label__negative
By the time we finished our dinner we still had not received one beverage NOR hooka !	__label__negative
What we did do was waste 3 hours being trapped in a table waiting and waiting for food and drinks and hooka.. some of which we never received !	__label__negative
The only beverage we did receive was water in dirty glasses !	__label__negative
To top it all off.. the main reason we came to your restaurant was for the belly dancers and missed the first show as we were not seated yet and the 2nd belly dancer only danced at two tables in the back of the restaurant and never made it around to the other half of the restaurant .	__label__negative
By the time we left our wallets were empy and so were our stomachs AND we missed the show we were supposed to see following our dinner , which would have been acceptable if we got to enjoy the experience of good food and belly dancers !	__label__negative
If it seemed possible to do so while there I would have fought my bill since my dinner portion of my meal was inedible !	__label__negative
I have never left a restaurant feeling as if i was abused ,	__label__negative
MY husbands birthday and my sons was not as it was intended ... and we drove two hours to spend too much money to be treated terribly !	__label__negative
I wish I COULD be refunded !	__label__negative
Do n't go with a larger group than 4 !	__label__negative
Do n't go with a larger group than 4 !	__label__negative
Do n't go with a larger group than 4 !	__label__negative
Do n't go with a larger group than 4 !	__label__negative
At first we were a little taken aback , as this seemed to present a problem , although the restaurant looked fairly empty , but they hastily put the table together for us .	__label__positive
The menu is fairly simple without much descriptions .	__label__neutral
There was no tap beer that evening , which was a disappointment	__label__negative
Not much of a selection of bottled beer either , we went with Brahma .	__label__negative
The appetizers we ordered were served quickly - an order of fried oysters and clams were delicious but a tiny portion ( maybe 3 of each ) .	__label__positive
The lobster knuckles ( special of the day ) were	__label__negative
believe there were 2 shrimp in the `` salt encrusted shrimp '' appet izer .	__label__negative
believe there were 2 shrimp in the `` salt encrusted shrimp '' appet izer .	__label__negative
believe there were 2 shrimp in the `` salt encrusted shrimp '' appet izer .	__label__negative
believe there were 2 shrimp in the `` salt encrusted shrimp '' appet izer .	__label__negative
She replied `` well it would be more convenient for us if you ordered now , since you are a larger party , and it might get crowded . ''	__label__negative
She replied `` well it would be more convenient for us if you ordered now , since you are a larger party , and it might get crowded . ''	__label__negative
The food arrived in about 15 minutes .	__label__neutral
I had the Thai style Fried Sea Bass ... which was very good .	__label__positive
, except my brother who had the  grilled Mahi Mah i , seemingly drenched in Grapfruit Juice	__label__negative
I heard the lobster roll was excellent .	__label__positive
They seemed to continue to rush us along , taking plates without asking if we were done ( my sister still had her fork in hand ) .	__label__negative
All in all the food was good - a little on the	__label__negative
 Service not the friendliest to our `` large	__label__negative
Probably would not go back here .	__label__negative
Great Indian food 	__label__positive
Great Indian food 	__label__positive
 Food was amazing - I love Indian food	__label__positive
Very `` norma l Indian fo od '' , but done really well	__label__positive
this place does n't have an ups cale feel .	__label__negative
Also ,  waiter s try to push more food on	__label__negative
I do n't appreciate places or people that try to drive up the bill without the patron 's knowledge so that was a huge turnoff ( more than the price ) .	__label__negative
is complimentary , then this is th e pla ce to go for Indian food	__label__negative
One of the BEST	__label__positive
 Bukhara Grill , the tagline says it all.. ``	__label__positive
 Bukhara Grill , the tagline says it all.. ``	__label__positive
The lunch buffet is expensive but is deff worth it	__label__positive
The lunch buffet is expensive but is deff worth it	__label__positive
We have gone for dinner only a few times but the same	__label__positive
 Bukhara is on my top 5 Indian places	__label__positive
Wretched and retching	__label__negative
Wretched and retching	__label__negative
Wretched and retching	__label__negative
been so disgusted by both food an service .	__label__negative
For starters they delivered us someone else 's order .	__label__negative
For starters they delivered us someone else 's order .	__label__negative
order of what Dokebi thinks passes as  Korean fai r , ( sometimes you have to	__label__negative
order of what Dokebi thinks passes as  Korean fai r , ( sometimes you have to	__label__negative
My main concern was the sanity of the food that was being sent out to myself and others , but I would be lying is I said that as someone who has worked in restaurants since the age of fifteen I was expecting at least a minimal effort on the part of the restaurant to amend the situation .	__label__negative
None was made so i hung up .	__label__negative
Less than three minutes passed before I found myself doubled over the toilet .	__label__negative
My girlfriend , being slightly more aggressive , and having been equally disgusted causing her to throw out the remainder of her barely eaten meal , called back only to be informed that I was probably wrong and that it was most likely an oyster , and that we were also blacklisted from their restaurant .	__label__negative
My girlfriend , being slightly more aggressive , and having been equally disgusted causing her to throw out the remainder of her barely eaten meal , called back only to be informed that I was probably wrong and that it was most likely an oyster , and that we were also blacklisted from their restaurant .	__label__negative
My girlfriend , being slightly more aggressive , and having been equally disgusted causing her to throw out the remainder of her barely eaten meal , called back only to be informed that I was probably wrong and that it was most likely an oyster , and that we were also blacklisted from their restaurant .	__label__negative
It was n't as if this  restauran t had any major bragging points before	__label__negative
Eat at your own risk .	__label__negative
Gorgeous place ideal for a romantic dinner	__label__positive
Gorgeous place ideal for a romantic dinner	__label__positive
I book a gorgeous white organza tent which included a four course prix fix	__label__positive
The service was spectacular as the waiter knew everything about the menu and his	__label__positive
I completely recommend Casa La Femme for any special occasion and to REALLY	__label__positive
More Williamsburg Garbage	__label__negative
More Williamsburg Garbage	__label__negative
More Williamsburg Garbage	__label__negative
The dishes came out around 5 minutes apart .	__label__negative
The bibimbap was average , but the  stone bow l was n't even close to sizzling	__label__negative
paid an extra $ 2 for the  stone bow l .	__label__negative
The nakgi-bokum was horrible .	__label__negative
Easily the worst stir-fried squid I 've ever tasted .	__label__negative
The sauce tasted more like Chinese fast food than	__label__negative
The side dishes were passable , and I did get	__label__positive
this place was the complete lack of service .	__label__negative
this place was the complete lack of service .	__label__negative
She just nodded and walked off .	__label__negative
She just nodded and walked off .	__label__negative
As to my comment about the food , no apology or acknowledgment was made .	__label__negative
had barely touched that mess of a dish .	__label__negative
We were charged full price .	__label__negative
We were charged full price .	__label__negative
We were charged full price .	__label__negative
Lives up to the hype	__label__positive
Lives up to the hype	__label__positive
We 've tried before but it always packed and does n't take reservations .	__label__neutral
It was well worth the wait .	__label__positive
The wife had the risotto which was amazing .	__label__positive
It does n't look appetizing as it 's covered in squid ink and it turns your lips and teeth black , but the taste was phenomenal .	__label__positive
The farro salad and the mashed yukon potatoes were also extremely tasty .	__label__positive
i love margherita pizza – i looove east village pizza	__label__positive
Love this place , every time we are in the	__label__positive
A quintessential slice of NYC pizza .	__label__neutral
to it , the salt from th e chee se is great , really heightens the	__label__positive
Personally I like the margherita pizza better , but they are all good .	__label__positive
Possibly the Most Romantic Restaurant in the City	__label__positive
This is undoubtedly my favorite modern Japanese brasserie ( that don ’ t serve sushi	__label__positive
wooden doors , the zen and intimat e déc or will make you feel like you	__label__positive
the ones on the ground level that  have glass ce ilings so you may see the stars	__label__positive
occasional cute ‘ excuse me ’ before the wa iter opens the little curtain to your	__label__positive
My party had the BBE $ 29 fixe prix men u , which was such a wonderful	__label__positive
My party had the BBE $ 29 fixe prix men u , which was such a wonderful	__label__positive
We started off with a delightful sashimi amuse bouche .	__label__positive
We started off with a delightful sashimi amuse bouche .	__label__positive
absolutely devoured while someone commented that the  Grilled Salmon dis h was better .	__label__positive
The entrees were served with miso soup and rice	__label__neutral
The sake ’ s complimented the courses very well and	__label__positive
( interesting but not extraordinary ) a nd matcha ( powdered green tea ) and blueberry chees ecake , which was phenomenal .	__label__positive
’ t say enough good things about  this bra sserie .	__label__positive
twice , but I ’ ll co me to Ze nkichi anytime for a quiet , unhurried	__label__positive
Terrible would be a compliment !	__label__negative
The service leaves much to be desired , from	__label__negative
The service leaves much to be desired , from	__label__negative
We paid a fixed pricce but got nothing ! !	__label__negative
We never ate because by close to 2 in the monring we were not served and were too upset ad tired to start eating .	__label__negative
They are extremely rude , not even apologizing for the horrible service we got and handing us a bill well over $ 500 for some drinks adn their pita bread !	__label__negative
Stay away	__label__negative
Great Shabu Shabu 	__label__positive
Great Shabu Shabu 	__label__positive
I love it .	__label__positive
I love it .	__label__positive
I tried a couple other dishes but was n't too impressed .	__label__neutral
But for the Shabu Shabu , you wo n't find much better	__label__positive
But for the Shabu Shabu , you wo n't find much better	__label__positive
are great , you get kimchi and a sal ad free with your meal and service	__label__positive
classic Korean food and fusion twists like pork belly tacos .	__label__positive
sandwich , perfect on its supermarket squis hy  bun .	__label__positive
Restaurant with a view 	__label__neutral
Restaurant with a view 	__label__neutral
The food tasted very good .	__label__positive
The family seafood entree was very good .	__label__positive
The main entree was also very good .	__label__positive
The main entree was also very good .	__label__positive
Price is high but the food is good , so I would come back again .	__label__positive
This place does n't make any sense	__label__negative
Just want to warn you all - do n't waste your time and money .	__label__negative
weird decor , stairs going up with  mirrored wall s - I am surprised how no	__label__negative
This place is not inviting and the food is totally weird .	__label__negative
The concept of japanese tapas is newly created and clearly does n't	__label__negative
The food they serve is not comforting , not	__label__negative
The food they serve is not comforting , not	__label__negative
Good Food 	__label__positive
Good Food 	__label__positive
was great and tasty , but the  sitting spac e was too small , I do	__label__negative
all it was a very nice romantic place .	__label__positive
all it was a very nice romantic place .	__label__positive
Loved it	__label__positive
A coworker and I tried Pacifico after work a few Fridays and loved	__label__positive
The atmosphere was great .	__label__positive
, although I would n't say th e margarit as were anything to write home about	__label__neutral
Our waitress was n't mean , but not especially	__label__neutral
surprised by the bad reviews of the restaurant earlier in the year , though .	__label__positive
surprised by the bad reviews of the restaurant earlier in the year , though .	__label__positive
Regardless , we 'll be back and ca n't wait to visit in the summer to take advantage of the patio .	__label__positive
Dumbfoundingly Poor	__label__negative
This was , from start to finish , a mind-bogglingly uncomfortable experience .	__label__negative
Lexicographers take note : a new and fascinating definition of rudeness is alive and flourishing right here in Brooklyn .	__label__negative
The servers at Flatbush Farm appear to have perfected	__label__negative
Polite acknowledgement is out ;	__label__negative
supercilious scorn is in .	__label__negative
And how many times can you pick up the same perfectly aligned set of napkins , inspect them vapidly and plonk them down in exactly the same place instead of venturing a glance at people who are there to help you make the rent ?	__label__negative
in front of us halfway through our  appetize r ( which was delicious ) .	__label__positive
Overall the food quality was pretty good , though I hear the salmon is much better when it has n't sat cooling in front of the guest .	__label__negative
The place has a nice fit-out , some attractive furnishings and , from what I could tell , a reasonable wine list ( I was given the food menu when I asked for the carte des vins )	__label__negative
At $ 120 for two people , however , this in no way represents value , unless you 're looking to pay by the hour for passive-aggressive torture .	__label__negative
On that scale , it 's a world-beater .	__label__negative
How is this palce still open ?	__label__negative
I honestly do n't even know where to begin .	__label__negative
I honestly do n't even know where to begin .	__label__negative
We arrived and were seated immediately , which made us both happy .	__label__positive
We arrived and were seated immediately , which made us both happy .	__label__positive
was going good until we got our meals .	__label__negative
I took one look at the chicken and I was appalled .	__label__negative
, over a bed of extremely undercooked  spinac h and mashed potatoes .	__label__negative
, over a bed of extremely undercooked  spinac h and mashed potatoes .	__label__negative
took one bite from the $ 24  salmo n , and I have never ,	__label__negative
At this point , the  waitres s comes over and asks us if	__label__negative
meat and spinach again , but th e spina ch was so undercooked that I just	__label__negative
I could n't even enjoy the mashed potatoes because it was hidden completely under the chicken and spinach .	__label__negative
I could n't even enjoy the mashed potatoes because it was hidden completely under the chicken and spinach .	__label__negative
So I decide to report back to the waitress because it was completely inedible .	__label__negative
Guess what , I waited for TWENTY minutes before she came over and when she finally did , she says , `` oh well , I wish you would have said something earlier '' No apology , nothing .	__label__negative
After that she simply took our plates , walked away , came back another TWENTY minutes later with the bill and the chicken on it ! ! ! ! ! ! ! ! ! ! ! !	__label__negative
No desert menu , no apology , nothing ! ! ! ! ! !	__label__negative
No desert menu , no apology , nothing ! ! ! ! ! !	__label__negative
it really really gets bad : the  manage r said , there is absolutely nothing	__label__negative
Again , no apology , no is there anything else I can get you , no can I get you a drink to make up for it , nothing ! ! ! !	__label__negative
Again , no apology , no is there anything else I can get you , no can I get you a drink to make up for it , nothing ! ! ! !	__label__negative
The level of rudeness was preposterous .	__label__negative
we did enjoy , the drinks an d appetize rs , and walked out .	__label__positive
I HAVE NEVER EVER HAD SUCH AN UNPLEASANT EXPERIENCE .	__label__negative
THIS STAFF SHOULD BE FIRED .	__label__negative
cirspy crust margherita pizza 	__label__positive
cirspy crust margherita pizza 	__label__positive
it was really good pizza .	__label__positive
the crust was imazingly cooked well and pizza was fully loaded : ) : )	__label__positive
you know what i mean all the positives things happening there made mw write this review .	__label__positive
Single Worst Restaurant in Manhattan	__label__negative
decor , good pita and hummus , and grilled oct opus that was actually pretty tasty .	__label__positive
decor , good pita and hummus , and grilled oct opus that was actually pretty tasty .	__label__positive
stars I would do so for this place .	__label__negative
stars I would do so for this place .	__label__negative
The reason there are 4 different results on citysearch for the same place is because they keep trying to start a new thread so they can stock it with positive reviews .	__label__negative
Well ... they can run but they ca n't hide .	__label__negative
Well ... they can run but they ca n't hide .	__label__negative
Well ... they can run but they ca n't hide .	__label__negative
Well ... they can run but they ca n't hide .	__label__negative
This place ... god where do i begin .	__label__negative
It is quite a spectacular scene i 'll give them that .	__label__positive
The decor however seems to be the distraction so you wo n't notice that you just payed 300 bucks for some cold eggplant that took 2 FRICKIN HOURS TO COME ! ! ! !	__label__negative
How this place survives the competitive west village market in	__label__negative
Great Hot Dogs !	__label__positive
Great Hot Dogs !	__label__positive
crowded most times I 've gone here  , B ark always delivers on their food .	__label__neutral
are top notch , and they 'r e Slamwi ch is amazing !	__label__positive
Going to Bark is always worth the train ride , and will make your tongue and belly very happy !	__label__positive
less on each item listed on th e me nu .	__label__negative
But nonetheless -- great spot , gre at f ood .	__label__positive
Fabulous food - if the front of house staff do n't put you off –	__label__negative
Fabulous food - if the front of house staff do n't put you off –	__label__negative
It 's a little out of our price range for dining there except on special occasions , but we 've eaten there 6 times in the last 2 years .	__label__negative
that were it not for the excepti onal fish d ishes I would never return .	__label__positive
As BFC does n't take reservations you almost always have to wait by the bar - and be abused by the front of house staff until you are seated , which can be over an hour later !	__label__negative
The frizzy retro girl ( with winged/ Dame Edna glasses )	__label__negative
I was almost amused by the fact that she was turning away customers at 9pm on a Friday night because she `` had a BBQ to go to '' that night - WTF ? ?	__label__negative
I 'd be horrified if my  staf f were turning away customers so early	__label__negative
There 's another  gir l who I ca n't describe ,	__label__negative
I 'm a friendly person , so I would n't mind had she not been so nasty and gotten so personal .	__label__negative
Again , I 'd be super upset if that were my employee .	__label__negative
Considering you will spend at least $ 60 a head , I expect better service .	__label__negative
So , if you 're walking by and thinking about dining , you might want to see who 's going to be seating you first ...	__label__negative
 Maitre-D - '' Eat and get out ''	__label__negative
 Maitre-D - '' Eat and get out ''	__label__negative
and service were fine , however the  maitre- D was incredibly unwelcoming and arrogant .	__label__negative
finishing our meals which included a high-end bottle of wine , our son 's fiance joined us	__label__positive
such a display of bad behavior b y a fron tman in a restaurant .	__label__negative
His response was smug , arrogant , and condescending , totally consistent with his deportment on display all evening .	__label__negative
ca n't dine here and disturb th e maitre -D 's sense of `` table turnover	__label__negative
If you go here , do it on his off-night .	__label__negative
Best meal in a long time !	__label__positive
Mussles and calamari were superb Saturday evening .	__label__positive
I had the Lamb special which was perfect .	__label__positive
My father had the flank steak which was very good , and my	__label__positive
 The Four Seasons restaurant is a great experience .	__label__positive
The food is great and the environment is even better .	__label__positive
Everyone must come here at least once .	__label__positive
Highly recommend it !	__label__positive
Taking Hot Dogs to the next level	__label__positive
you do n't just get your averag e hot d og .	__label__positive
Here the hot dog is elevated to the level of a	__label__positive
Great Atmosphere 	__label__positive
Great Atmosphere 	__label__positive
I highly recommend the fish tacos , everything else was ok .	__label__neutral
Cool atmosphere , the fire place in the back really ads to it but needs a bit more heat throughout on a cold night .	__label__negative
Poor service and management 	__label__negative
Don ’ t go to thi s pla ce !	__label__negative
Had an awful experience at Casa la Femme on a Saturday dinner .	__label__negative
Appetizers took nearly an hour .	__label__negative
When the main course finally arrived ( another 45mins ) half of our order was missing .	__label__negative
Never got an explanation as to what was going on .	__label__negative
The manager was rude and handled the situation extremely	__label__negative
When we threatened to leave , we were offered a meager discount even though half the order was missing .	__label__negative
On the way out , we heard of other guests complaining about similar issues .	__label__negative
Can ’ t believe how an expensive NYC restaurant can be so disrespectful to its clients .	__label__negative
What a hassle !	__label__negative
The food is very good , but not outstanding	__label__neutral
the attitude of the staff or the  wai t for a table .	__label__negative
On our last visit , they skipped over our name on the list , leaving us waiting an extra hour for a table .	__label__negative
that we received from the Al Di  La s taff .	__label__negative
that we received from the Al Di  La s taff .	__label__negative
Expensive	__label__negative
Expensive	__label__negative
Expensive	__label__negative
The bread was stale , the  sala d was overpriced and empty .	__label__negative
The pasta was well cooked , did n't have	__label__negative
The pasta was well cooked , did n't have	__label__negative
So rude ! ! !	__label__negative
So rude ! ! !	__label__negative
So rude ! ! !	__label__negative
I was one of the people that went for this horrible experience .	__label__negative
I was one of the people that went for this horrible experience .	__label__negative
The hostess was rude and I got a distinct feeling that they did not want to serve us .	__label__negative
we sat down at the bar the bartender disappeared .	__label__negative
asked for a menu and the same waitress looked at my like I was insane	__label__negative
my friends wanted to stay after the waitress said , `` can I help you	__label__negative
my friends wanted to stay after the waitress said , `` can I help you	__label__negative
The three of us standing in front of her should have been an indication of how many of us there were .	__label__negative
We did n't look like the other patrons in there so unfortunately I think that may have been part of the problem .	__label__negative
for the horrible rude staff and non-existent customer service .	__label__negative
bad staff 	__label__negative
I generally like this place .	__label__positive
The food is good .	__label__positive
The design of the space is good .	__label__positive
But the service is HORRID !	__label__negative
tag teamed by a waitress and a  waite r .	__label__negative
The waiter delivered our food while holding what appeared	__label__negative
I ca n't believe that it was , but please put the bag down before delivering food !	__label__negative
The waitress came to check in on us every	__label__negative
I could n't ignore the fact that she reach over the plate of one of my friends , who was in mid bite , to clear the table .	__label__negative
She then put the check down without asking if we were done , and came to check on the bill every two minutes , even though we were one of three occupied tables .	__label__negative
and I wish someone would retrain the  staf f .	__label__negative
