posts this used to be a good place , but not any longer .	__label__negative
the place was empty - and th e sta ff acted like we were imposing on	__label__negative
They never brought us complimentary noodles , ignored repeated requests for sugar , and threw our dishes on the table .	__label__negative
too sweet or too salty and the portions tiny .	__label__negative
After all that , they complained to me about the small tip .	__label__negative
Avoid this place !	__label__negative
at Saul , many times , th e fo od is always consistently , outrageously good	__label__positive
 Saul is the best restaurant on Smith Street	__label__positive
The duck confit is always amazing and the foie gras	__label__positive
The wine list is interesting and has many good values	__label__positive
For the price , you can not eat this well in Manhattan .	__label__positive
I was very disappointed with this restaurant .	__label__negative
Ive asked a cart attendant for a lotus leaf wrapped rice and	__label__negative
I had to ask her three times before she finally came back with the dish Ive requested .	__label__negative
 Food was okay , nothing great .	__label__neutral
Chow fun was dry ; pork shu mai was more than usually greasy and had to share a table with loud and rude family .	__label__negative
I/we will never go back to this place again .	__label__negative
a 3 day oyster binge , with  Fis h bringing up the closing , and	__label__positive
Service was devine , oysters where a sensual as they come , and the price ca n't be beat ! ! !	__label__positive
You ca n't go wrong here .	__label__positive
I make it a point to visit Restaurant Saul on Smith Street .	__label__positive
, the service is excellent , th e dec or cool and understated .	__label__positive
I had the duck breast special on my last visit and it was	__label__positive
Ca n't wait wait for my next visit .	__label__positive
Ca n't wait wait for my next visit .	__label__positive
And I hate to say this but I doubt I 'll ever go back .	__label__negative
The food is very average ... the Thai fusion stuff is a bit too sweet , every thing they serve is too sweet here .	__label__negative
only thing I moderately enjoyed was their Grilled Chicken special with Edamame Puree .	__label__positive
I had never had Edamame pureed before but I thought it was innovative	__label__positive
I had never had Edamame pureed before but I thought it was innovative	__label__positive
but they REALLY need to clean tha t ve nt in the ceiling ... its quite	__label__negative
but they REALLY need to clean tha t ve nt in the ceiling ... its quite	__label__negative
but they REALLY need to clean tha t ve nt in the ceiling ... its quite	__label__negative
Their sake list was extensive , but we were looking for Purple Haze , which was n't listed but made for us upon request !	__label__positive
tuna roll was unusually good and the rock shrimp tempura was awesome , great appetizer to share	__label__positive
down a bit by then so the service was great !	__label__positive
we love th pink pony .	__label__positive
THe perfect spot .	__label__positive
 Food -awesome .	__label__positive
 Service - friendly and attentive .	__label__positive
 Ambiance - relaxed and stylish .	__label__positive
Do n't judge this  plac e prima facie , you have to	__label__positive
Do n't judge this  plac e prima facie , you have to	__label__positive
Do n't judge this  plac e prima facie , you have to	__label__positive
the food is decent .	__label__neutral
however , it 's th e servi ce that leaves a bad taste in	__label__negative
self-respect , which includes not letting a  waite r intimidate me , i.e . make	__label__negative
i know , you were too busy showing off your vintage tee shirt and looking bored , but my agenda is i 'm here to eat and enjoy the company of friends , seeking a pleasant experience .	__label__negative
well , i did n't find it there , and trust , i have told everyone i can think of about my experience .	__label__negative
the last time i walked by it looked pretty empty . hmmm .	__label__negative
This place has got to be the best japanese	__label__positive
I had a great experience .	__label__positive
 Food is great .	__label__positive
 Service is top notch .	__label__positive
I have been going back again and again .	__label__positive
to judge a sushi restaurant by its sea urchin , which was heavenly at sushi rose	__label__positive
It melted in my little mouth and the perfect consistency-not too fishy , creamy , and slightly buttery .	__label__positive
The sushi seemed pretty fresh and was adequately proportioned	__label__positive
The rice to fish ration was also good -- they did n't	__label__positive
We took advanatage of the half price sushi deal on saturday so it was well worth	__label__positive
We took advanatage of the half price sushi deal on saturday so it was well worth	__label__positive
We took advanatage of the half price sushi deal on saturday so it was well worth	__label__positive
Surprisingly nothing could be further from the truth .	__label__positive
a well dressed , with it , NY cr owd .	__label__positive
The food was well prepared and the service impecable .	__label__positive
I 'm going back .	__label__positive
I 'm going back .	__label__positive
Quite simply it 's like stepping out of Manhattan and into a haven of tranquility .	__label__positive
Quite simply it 's like stepping out of Manhattan and into a haven of tranquility .	__label__positive
The Prix Fixe menu is worth every penny and you get	__label__positive
I will be going back and heartily recommend it !	__label__positive
I will be going back and heartily recommend it !	__label__positive
It is terrific , as is the value .	__label__positive
$ 6 and there is much tasty  foo d , all of it fresh and	__label__positive
a vegetarian but , almost all the  dishe s were great .	__label__positive
a vegetarian but , almost all the  dishe s were great .	__label__positive
Go hungry and enjoy .	__label__positive
The food here is rather good , but only if you like to wait for it .	__label__negative
the chole , but the dhosas a nd d hal were kinda dissapointing .	__label__negative
The service varys from day to day- sometimes they	__label__negative
The kitchen however , is almost always slow .	__label__negative
Also , specify if you like your  foo d spicy- its rather bland if you	__label__negative
The ambience is pretty and nice for conversation , so a casual lunch here would probably be best .	__label__positive
The ambience is pretty and nice for conversation , so a casual lunch here would probably be best .	__label__positive
have an idea of the top of  vie w the chart house has to offer	__label__positive
Add to that great service and great food at a reasonable price and you have	__label__positive
The lava cake dessert was incredible and I recommend it .	__label__positive
Once you step into Cosette , you 're miraculously in a small	__label__positive
This tiny restaurant is as cozy as it gets ,	__label__positive
yet not overly impressive , and th e desser ts not brilliant in any way .	__label__negative
for the ambience , and consider th e fo od just a companion for a trip	__label__neutral
for the ambience , and consider th e fo od just a companion for a trip	__label__neutral
IT WAS HORRIBLE .	__label__negative
The pizza was delivered cold and the cheese was n't even fully melted !	__label__negative
It looked like shredded cheese partly done - still in strips .	__label__negative
It looked like shredded cheese partly done - still in strips .	__label__negative
This has got to be one of the most overrated restaurants in Brooklyn .	__label__negative
The pizza is overpriced and soggy .	__label__negative
unless someone knows how to get t he cr ust right .	__label__negative
A big disappointment , all around .	__label__negative
think I 've had some the best  meal s of my life at minnow .	__label__positive
good wine list , and the ever-changi ng m enu always offers some great surprises .	__label__positive
The combination of super-fresh ingredients in the dishes are unusual but really	__label__positive
Worth the trip from Manhattan .	__label__positive
Worth the trip from Manhattan .	__label__positive
Best Pastrami I ever had and great portion without being ridiculous .	__label__positive
Best Pastrami I ever had and great portion without being ridiculous .	__label__positive
My wife had the fried shrimp which are huge and loved it .	__label__positive
My wife had the fried shrimp which are huge and loved it .	__label__positive
I was just so amazed at th is pl ace .	__label__positive
This place is the most Japanese it can ever	__label__positive
, food , and even all t he waitst aff are ALL TOTALLY Japanese .	__label__positive
This place is worth an one-hour drive .	__label__positive
I am so coming back here again , as much as I can .	__label__positive
but hip , with well prepared basi c French bistro fa re , good specials , a warm	__label__positive
not always well trained but nevertheless friendly , sta ff , all of whom have a	__label__positive
not always well trained but nevertheless friendly , sta ff , all of whom have a	__label__positive
Decent wine at reasonable prices .	__label__positive
Have been dozens of times and never failed to enjoy the experience .	__label__positive
Our teenage kids love it , too .	__label__positive
that I did n't just go t o Zucchero Pomodo ri .	__label__positive
This is by far my favorite place in the neighborhood .	__label__positive
food is delicious and comes in larg e portio ns .	__label__positive
food is delicious and comes in larg e portio ns .	__label__positive
I 'm partial to the  Gnocch i .	__label__positive
This place is incredibly tiny .	__label__negative
They refuse to seat parties of 3 or more on weekends .	__label__negative
The hostess is rude to the point of being	__label__negative
The food was bland oily .	__label__negative
I just do n't understand all the hype ...	__label__negative
I just do n't understand all the hype ...	__label__negative
have great food , wine , a nd serv ice .	__label__positive
but somehow managed to have a short  wai t .	__label__positive
As always we had a great glass of wine while we waited .	__label__positive
sat , we got great and fast  servic e .	__label__positive
The people that work there are always so friendly	__label__positive
Make sure you try this place as often as you can .	__label__positive
This is a fun restaurant to go to .	__label__positive
pizza is yummy and I like the atmoshpere .	__label__positive
But the pizza is way to expensive .	__label__negative
But the pizza is way to expensive .	__label__negative
I went there for lunch and it was not as good as	__label__negative
Sauce was watery and the food did n't have much flavor .	__label__negative
Sauce was watery and the food did n't have much flavor .	__label__negative
I do n't think I would go again .	__label__negative
This place is great .	__label__positive
I had a huge group for my birthday and we were well taken care of .	__label__positive
was very patient with us and the food is phenomenal !	__label__positive
 Service was prompt , friendly and great .	__label__positive
Slightly on the pricey side but worth it !	__label__positive
Great pizza and fantastic service .	__label__positive
There was a small wait , but shorter than I expected .	__label__positive
Located at the end of a magnificent block .	__label__positive
Very cozy and warm inside ... ..	__label__positive
I will be back !	__label__positive
This is the best sushi in new york city - hands down	__label__positive
place is small and cramped but the food is fantastic .	__label__positive
Get the tuna of gari .	__label__positive
Get the tuna of gari .	__label__positive
 Planet Thailand has always been a hit with me	__label__positive
With the great variety on the menu , I eat here often and never	__label__positive
The atmosphere is n't the greatest , but I suppose that 's how they keep the prices down .	__label__positive
It 's all about the  foo d ! !	__label__positive
It 's all about the  foo d ! !	__label__positive
us a long time to find the place .	__label__negative
us a long time to find the place .	__label__negative
but when we looked at the menu , there were n't a lot of	__label__negative
but when we looked at the menu , there were n't a lot of	__label__negative
were big , but not good and  sashim i was n't fresh .	__label__negative
they were dry and disgusting , i did n't even finish my first piece .	__label__negative
Hurley 's is like Cheers where everyone knows your name and they are ACTUALLY glad you came .	__label__positive
Try the crunchy tuna , it is to die for .	__label__positive
Try everything for that matter , it is all good .	__label__positive
I have been going there since it opened and I ca n't get enough .	__label__positive
First went here to enjoy their garden terrace .	__label__positive
The food was amazing , and the  servic e was prompt and helpful , but	__label__positive
The Steak Tartare is a great bet , they fix	__label__positive
Admittedly some nights inside the restaurant were rather warm , but the open	__label__negative
is worth the price , and th e house champag ne is a great value .	__label__positive
is good and it is the best  French foo d you will find in the area	__label__positive
Have recommended the place to friends , always gets good response	__label__positive
Pizza - the only pizza in NYC that should not have additional	__label__positive
Pizza - the only pizza in NYC that should not have additional	__label__positive
Pizza - the only pizza in NYC that should not have additional	__label__positive
I take all my NYC guests to VT ' s .	__label__positive
in a great neighborhood and has gre at f ood !	__label__positive
I 've been there three times and have always had wonderful experiences .	__label__positive
I 'd highly recommend it for a special occasion -- it provides and intimate setting and nice service .	__label__positive
because my friends and I all enjoy  Miz u very much ... and we 're	__label__positive
Even after they overcharged me the last time I was there .	__label__negative
Make sure you have the Spicy Scallop roll .. .	__label__positive
it 's delicious !	__label__positive
Moules were excellent ,  lobster raviol i was VERY salty !	__label__negative
for Mother 's Day , and th e maitre  d ' was pretty rude .	__label__negative
Told us to sit anywhere , and when we sat he said the table was reserved .	__label__negative
Stepped on my foot on the SECOND time he reached over me to adjust lighting .	__label__negative
Tiny dessert was $ 8.00 ... just plain overpriced	__label__negative
The drinks are always welll made and wine selection is fairly priced .	__label__positive
Try their chef 's special s -- they are to die for	__label__positive
 Service is not exactly five star , but	__label__neutral
 Downstairs lounge is always a good attraction	__label__positive
 Raga ' s is a romantic , cozy restaurant	__label__positive
The exotic food is beautifully presented and is a delight	__label__positive
It is also extremely well priced .	__label__positive
The staff is incredibly helpful and attentive .	__label__positive
stocked with interesting beers and well priced wines .	__label__positive
This is one of my favorite restaurants and it is not to be missed .	__label__positive
Your friends will thank you for introducing them to this gem !	__label__positive
When we stumbled on Leon , we thought that we had found	__label__negative
The waitress moved our table practically into the bathroom	__label__negative
Then , to top things off , she dropped used silverware on my boyfriend 's jacket and did not stop to apologize or clean the mess that was left on clothes .	__label__negative
Such a disappointment ...	__label__negative
Rude service , medicore food ... there are tons of restaurants in NY ... stay away from this one	__label__negative
I had a grat time at Jekyll and Hyde !	__label__positive
loved everythig about it-especially the shows and actors .	__label__positive
Our server was very helpful and friendly .	__label__positive
I am bringing my whole family back next time .	__label__positive
The food was good too .	__label__positive
The tuna and wasabe potatoes are excellent .	__label__positive
The outdoor atmosphere of sitting on the sidewalk watching the	__label__positive
Inside is a little cramped , but to be expected .	__label__neutral
 Service was prompt and courteous .	__label__positive
This was a repeat visit and we 'll definitely be back again .	__label__positive
Great service , great  foo d .	__label__positive
Prices are in line .	__label__neutral
Prices are in line .	__label__neutral
But too far east !	__label__negative
But too far east !	__label__negative
The pizza is delicious - they use fresh mozzarella instead of the cheap , frozen ,	__label__positive
Two complaints- their appetizer selection stinks , it would be nice to	__label__negative
Also , because it is so thin , it gets cold very quickly and its not that filling .	__label__negative
Also , because it is so thin , it gets cold very quickly and its not that filling .	__label__negative
of your business but its the best pie on the UWS !	__label__positive
By far the best salad I have had in a fast food	__label__positive
fine dining restaurant quality .	__label__positive
Over 100 different choices to create your own .	__label__positive
A must try !	__label__positive
friend and I accidently found this great  restauran t on our way to see the	__label__positive
This was the perfect quiet , relaxing , and delicious accompaniment to our afternoon of theater .	__label__positive
cheeseburger huge and delictable , and th e servi ce professional wan warm .	__label__positive
With so many poor experiences to be had in the theater district , is truly an excellent find !	__label__positive
We will return many times for this oasis in mid-town .	__label__positive
We will return many times for this oasis in mid-town .	__label__positive
The staff is no nonsense .	__label__positive
The food options rule .	__label__positive
a while I would buy freeze the bagels and they would still be better than	__label__positive
Worth visiting the 1st Ave spot because it is the original store .	__label__positive
Worth visiting the 1st Ave spot because it is the original store .	__label__positive
Worth visiting the 1st Ave spot because it is the original store .	__label__positive
Worth visiting the 1st Ave spot because it is the original store .	__label__positive
Worth visiting the 1st Ave spot because it is the original store .	__label__positive
He served me an Uni Hand roll , which I never had before ,	__label__positive
He served me an Uni Hand roll , which I never had before ,	__label__positive
The sake menu should not be overlooked !	__label__positive
All in all , this midtown gem instantly became one of my favorite sushi restaurants in the city .	__label__positive
Try the lobster teriyaki and the rose special roll .	__label__positive
Try the lobster teriyaki and the rose special roll .	__label__positive
 Service was very good - prompt , attentive	__label__positive
budget selection ( though I wish th e pork bel ly that I ordered was roasted a	__label__negative
Wine list selection is good and wine-by-the-glass was generously filled to the top .	__label__positive
Traditional French decour was pleasant though the hall was rather noisy - the restaurant was	__label__negative
I 've been to at  Cafe Spic e probably 5-8 times , it is	__label__positive
To sum it up :  Servic e varies from good to mediorce ,	__label__neutral
 Seating is always prompt , though the restaurant	__label__positive
though ocasionally I wondered about freshmess of  raw vegatables in side order s .	__label__negative
As many other reviewers noticed , your order is often slow to arrive - this is particularly true in the evening but is not a problem during lunch time .	__label__neutral
decor is vibrant and eye-pleasing with several semi-private boths on the right side of the dining	__label__positive
I have NEVER been disappointed in the Red Eye .	__label__positive
taken by the live jazz band and  atmospher e , I ordered the Lobster Cobb	__label__positive
taken by the live jazz band and  atmospher e , I ordered the Lobster Cobb	__label__positive
It 's simply the best  mea l in NYC .	__label__positive
You can not go wrong at the  Red Eye Gril l .	__label__positive
side , we would genuinely miss this  restauran t .	__label__positive
side , we would genuinely miss this  restauran t .	__label__positive
The restaurant is cute but not upscale .	__label__neutral
is delicious and homemade with the perfect balance of herbs and tomatoes .	__label__positive
I would highly recommend it .	__label__positive
It 's one of our favorite places to eat in NY .	__label__positive
We had a great time at the Jekyll and hyde Pub last night .	__label__positive
We had a great time at the Jekyll and hyde Pub last night .	__label__positive
After really enjoying ourselves at the bar we sat down at a table and	__label__positive
The server was really cool and served us our	__label__positive
The place 's decor and  hidden bathroom s made for a good laugh .	__label__positive
I highly recommend visiting this restaurant and having dinner and drinks !	__label__positive
and entertained , this is a great  plac e to go and eat .	__label__positive
would be great to go to the Jekyll and Hyde Pub for our anniversary , and to our	__label__positive
recommend a dish it must be the  pumkin tortelin i .	__label__positive
The entertainment was great they have shows that go	__label__positive
my advice , go and try this  plac e .	__label__positive
my advice , go and try this  plac e .	__label__positive
You will not be disapointed at all .	__label__positive
You will not be disapointed at all .	__label__positive
We were not dissappointed in the least bit by this little gem .	__label__positive
The bagel was huge .	__label__positive
They were served warm and had a soft fluffy interior .	__label__positive
The workers there also absolutely load the bagel with cream cheese ( gets a little	__label__negative
I loved it and would HIGHLY RECOMMEND .	__label__positive
say how delicous the food and the  servic e was .	__label__positive
say how delicous the food and the  servic e was .	__label__positive
you can tell it was a fresh  lobste r .	__label__positive
pizza , santa fe chopped salad and  fish and chip s .	__label__positive
their food , the ambience and wonderfu l servi ce .	__label__positive
All the staff is absolutely professional ! !	__label__positive
All the staff is absolutely professional ! !	__label__positive
All the staff is absolutely professional ! !	__label__positive
( that is A MUST , but not every restaurant can do ... )	__label__positive
( that is A MUST , but not every restaurant can do ... )	__label__positive
There 's nice and quiet , small but enough for 6 ( or more ) .	__label__positive
This restaurant was way overhyped .	__label__negative
My chow fun and chow see was really bland and oily .	__label__negative
Okay-i do n't mind the oily part ( cause most are cooked that way ) but it was way too bland .	__label__negative
The scallion pancakes and fried dumplings were nothing out of the ordinary .	__label__neutral
was the only thing good about this restaurant .	__label__negative
the tuna was soggy and the oth er ro lls had no flavor .	__label__negative
I definitely would n't go back .	__label__negative
I definitely would n't go back .	__label__negative
Their pad penang is delicious and everything else is fantastic .	__label__positive
The price is reasonable although the service is poor .	__label__negative
fresh restaurant was amazing ... ... .. f ood was delicious and of course fresh	__label__positive
great for a romantic evening , or a fun evening with friends ...	__label__positive
I will be going back very soon .	__label__positive
keep up the good work .	__label__positive
Hats off to the chef .	__label__positive
Hats off to the chef .	__label__positive
Hats off to the chef .	__label__positive
It was wonderful .	__label__positive
the salads are delicious , both refreshing and very	__label__positive
We had Pam 's special fried fis h and it was amazing .	__label__positive
too large for just two people but nothing was left .	__label__positive
too large for just two people but nothing was left .	__label__positive
too large for just two people but nothing was left .	__label__positive
Great vibe , lots of people .	__label__positive
Great vibe , lots of people .	__label__positive
My husbands was perfect , my was well done and dry .	__label__negative
did n't complain , I liked th e atmosphe re so much .	__label__positive
did n't complain , I liked th e atmosphe re so much .	__label__positive
did n't complain , I liked th e atmosphe re so much .	__label__positive
On a hot day it was fabulous to stop in and enjoy lunch .	__label__positive
Ambience is so cute and quaint , good for business although we were there on vacation .	__label__positive
 Salads were fantastic .	__label__positive
for regular lettuce and some walnuts the salads we got were great .	__label__positive
 Ingredients are organic which is a real plus	__label__positive
We will be back .	__label__positive
This is some really good , inexpensive  sush i .	__label__positive
This is some really good , inexpensive  sush i .	__label__positive
The spicy Tuna roll is huge and probably the best that	__label__positive
The Yellowtail was particularly good as well .	__label__positive
I have reservations about the all you can eat deal , however -- the choices are fairly	__label__negative
In any event , this is a  plac e I 'll be sure to stop	__label__positive
 Big Wong gets big Ups for a fine establishment	__label__positive
-- great price , food , an d servi ce .	__label__positive
The atmosphere is noisy and the waiters are literally walking around doing things as	__label__positive
The food is prepared quickly and efficiently .	__label__positive
price ( congee , noodles , a nd rice dis hes are no more than $ 3-6	__label__positive
The takeout is great too since they give high	__label__positive
This place is always very crowded and popular .	__label__positive
This place is always very crowded and popular .	__label__positive
nice Caesar Salad while my wife had arugula and goat cheese ... .both very tasty .	__label__positive
We both opted for a pasta dish and they were served timely and fresh	__label__positive
We concluded with tiramisu chocolate cake , both were delicious .	__label__positive
We 'd go back again	__label__positive
I recently went to this restaurant with some co-workers for lunch and had	__label__positive
the food was absolutely delicious and the  plac e is lovely .	__label__positive
We even had a visit from the Manager who wanted to make sure we were	__label__positive
Yes , the prices are high , but I felt it was worth it .	__label__positive
We all felt it was worth it .	__label__positive
sometimes i get good food and ok service .	__label__neutral
bad service , sometimes i get good  goo d and bad service .	__label__positive
it is not consistent .	__label__negative
it is not consistent .	__label__negative
and wine served efficiently in a bustling  atmospher e .	__label__positive
And where does Patis go wrong ; no where .	__label__positive
You are not eating haut cuisine with subtle hints of whatever but : Cassuolet , Steake Fritte , Tripe Stew , etc ; simple stuff .	__label__positive
And evaluated on those terms Pastis is simply wonderful .	__label__positive
in Brooklyn this is a nice cozy place with good pizza .	__label__positive
Mine was a little burnt but still delicious with goat cheese and panchetta ( raddichio was kind of bitter though ) .	__label__positive
My friend got the mushroom pizza which tasted better .	__label__positive
The sangria was pretty tasty and good on a	__label__positive
Kind of a small place but I guess if they are not	__label__neutral
Overall I would recommend it and go back again .	__label__positive
Overall I would recommend it and go back again .	__label__positive
I started out with a Bombay beer which was big enough for two .	__label__positive
I started out with a Bombay beer which was big enough for two .	__label__positive
MMmmm ... it was delicious .	__label__positive
Service was slow , but the  peopl e were friendly .	__label__positive
It 's a nice  plac e to relax and have conversation .	__label__positive
I ca n't wait to go back .	__label__positive
I ca n't wait to go back .	__label__positive
The food is authentic Italian - delicious !	__label__positive
Pizza is terrific , as is  homemade past a .	__label__positive
Ambience is delightful ,  servic e impeccable .	__label__positive
that i had to pay for lousy  foo d .	__label__negative
hanger steak was like rubber and the tuna was flavorless not to mention it tasted	__label__negative
Service was also horrible and the ambience is not that great .	__label__negative
DO not try unless you 're just going there to hang out like the rest of the hipsters who apparently have no sense of taste .	__label__negative
many different restaurants and this is one place you have go and try .	__label__positive
for a restaurant because the food and service was excellent .	__label__positive
The filet mignon dish was superb !	__label__positive
I would defiantly come back here again as one of my top choices .	__label__positive
It 's a small cute  restauran t .	__label__positive
I absolutely love this place ! ! !	__label__positive
I absolutely love this place ! ! !	__label__positive
I like the ambience , it 's very dark and original	__label__positive
I like the ambience , it 's very dark and original	__label__positive
The sushi is amazing ! ! !	__label__positive
And amazingly cheap .	__label__positive
Big thumbs up !	__label__positive
Very affordable and excellent ambient !	__label__positive
We ordered some beef and noodle soup dishes from the Thai section of the menu	__label__negative
We were very disappointed .	__label__negative
to this place again for a good  mea l .	__label__negative
However , I think this  plac e is a good hang out spot	__label__positive
However , I think this  plac e is a good hang out spot	__label__positive
Girlfriend and I stumbled onto this hopping place the other night and had a great	__label__positive
what really MADE this place was th e backyard dining ar ea .	__label__positive
It is one the nicest outdoor restaurants I have ever seen in NY --	__label__positive
They tell me they are going to cover the garden in glass for the winter , so i 'm looking forward to going there on a snowy night to enjoy it .	__label__positive
Check this place out !	__label__positive
HIGHLY RECOMMENDED ! ! ! ! !	__label__positive
First of all , this  plac e is *not* romantic , as claimed	__label__negative
Either that , or the editor 's idea of romance must be sharing a conversation with the next table , while trying to speak louder than the traffic on 57th .	__label__negative
of any Italian restaurant , and th e wine li st is simply overpriced .	__label__negative
Slightly above average wines start at $ 70+ with only one	__label__negative
 Service is not what one would expect from	__label__negative
For instance , plates were just dumped on the table , I was handed the wine list upside down , etc ... .	__label__negative
constant mille grazie does not constitute proper service .	__label__negative
make up for all the other deficiencies  of Teo dora .	__label__negative
make up for all the other deficiencies  of Teo dora .	__label__negative
edible - bland and/or made with weird rosemary or orange flavoring .	__label__negative
 Fish was overdone .	__label__negative
Cute place , nice wait staff but would never	__label__negative
Someone else recommended the dessert - we also left that .	__label__negative
One of us actually liked the expresso - that 's it .	__label__positive
Skip this restaurant , it 's a big disappointment .	__label__negative
 Myagi is one of my favorite restaurants in	__label__positive
've never had bad service and the  fis h is fresh and delicious .	__label__positive
Their tuna tartar appetizer is to die for .	__label__positive
'm almost ashamed to say that th e piz za in Fornino 's blows my families	__label__positive
It is simply amazing .	__label__positive
The place is so cool and the service is	__label__positive
highly recommend to anyone to give this place a try .	__label__positive
You will find yourself returning quite often .	__label__positive
You will find yourself returning quite often .	__label__positive
You will find yourself returning quite often .	__label__positive
food with great service in a pleasant  atmospher e .	__label__positive
No gimmicks here -- the food speaks for itself in its freshness and	__label__positive
The dining room is quietly elegant with no music to	__label__positive
service was impeccable and unobtrusive -- the staff knows what they are there to do	__label__positive
enjoying a real meal in a real  restauran t , not a clubhouse of the	__label__positive
Beautiful experience .	__label__positive
the service is top notch ... the  ambianc e is wonderfull .	__label__positive
The staff offers impeccable service .	__label__positive
I had Lobster Bisque it has 2 oz . of Maine	__label__positive
think the award should go to the Lobster Bisque .	__label__positive
think the award should go to the Lobster Bisque .	__label__positive
It was divine melts in your mouth .	__label__positive
My boyfriend had Prime Rib it was good .	__label__positive
a weekday so we each got little  bottles of Korbet t it was just enough .	__label__positive
a weekday so we each got little  bottles of Korbet t it was just enough .	__label__positive
It 's cuz it 's so good you need to taste it ! ! !	__label__positive
All in all we 're already coming up with excuses to go ahead really soon in the next few wks ! ! ! !	__label__positive
not stopped ranting and raving about the food .	__label__positive
If you like spicy food get the chicken vindaloo .	__label__positive
It 's very spicy but not offensive .	__label__positive
We will definitely go back .	__label__positive
Volare for 1st class service and terrific food .	__label__positive
The portions are large and the servers always surprise	__label__positive
The wine list is excellent .	__label__positive
amazing ... especially if you get the  Chef 's tasting me nu and your favourite bottle ( or	__label__positive
The place is small and intimate and you may	__label__positive
The place is small and intimate and you may	__label__positive
The food can get pricey but the prixe fixe tasting menu is the greatest food for a good price and they cater the food to any food allergies or food you do n't like .	__label__positive
The food can get pricey but the prixe fixe tasting menu is the greatest food for a good price and they cater the food to any food allergies or food you do n't like .	__label__positive
Please be aware that it 's CASH or AMEX only !	__label__neutral
With the exception of our lemon salad that had so much pepper on it	__label__negative
The menu is very limited - i think we	__label__negative
We ordered the special ,  grilled branzin o , that was so infused with	__label__negative
The decor in this place is very diner-ish and	__label__neutral
Problem is nothing at Prune is particularly memorable .	__label__negative
No plans to return anytime soon .	__label__negative
This place is so much fun .	__label__positive
Our family never expected such incredible entertainment in a restaurant .	__label__positive
Our family never expected such incredible entertainment in a restaurant .	__label__positive
Our family never expected such incredible entertainment in a restaurant .	__label__positive
Our food was great too !	__label__positive
And really large portions .	__label__positive
The staff was the friendliest that have seen in	__label__positive
We will go back every time we are in the City .	__label__positive
you want something really different than try Jekyll and Hyde .	__label__positive
It is a lot of fun with live entertainment and all kinds of Disney type special effects .	__label__positive
it was hot and good with large portions .	__label__positive
I highly recommend it .	__label__positive
I highly recommend it .	__label__positive
The place is a lot of fun .	__label__positive
My six year old loved it .	__label__positive
The characters really make for an enjoyable experience .	__label__positive
The food however , is what one might expect	__label__negative
It is very overpriced and not very tasty .	__label__negative
However , I think  Jeckll and Hyde s t is one of those places	__label__positive
We had a good time .	__label__positive
Went there with my wife and we had to wait for a table even though you could see there many that were empty with not reservation sigh on them .	__label__negative
 Service was slow had to wait to order	__label__negative
 Drinks way over priced .	__label__negative
Food was good not great not worth the wait or another visit	__label__negative
Great pizza for lunch place .	__label__positive
 Service was quick .	__label__positive
The pizza was great .	__label__positive
And it was quick which is very important .	__label__positive
And it was quick which is very important .	__label__positive
It was wonderful .	__label__positive
be there with quality fish and great  servic e .	__label__positive
 Delivery is fast too .	__label__positive
Fast seating , Fast Delivery , Excelle nt su shi .	__label__positive
A little overpriced but worth it once you take a bite .	__label__positive
A little overpriced but worth it once you take a bite .	__label__positive
midtown ) is by far the bes t bag el in NY .	__label__positive
The bagels always warm , soft on the inside	__label__positive
They have a huge selection of different cream cheeses and all of their salads are great	__label__positive
The lox is always fresh too .	__label__positive
Highly recommended to all !	__label__positive
Highly recommended to all !	__label__positive
Highly recommended to all !	__label__positive
Not impressed with the food .	__label__negative
too high for this cramped and unappealing resturant .	__label__negative
Zero ambiance to boot .	__label__negative
I thought this place was totally overrated .	__label__negative
Everything we had was good or ok ... .but definitely nothing great .	__label__neutral
The ambience was nice , but  servic e was n't so great .	__label__negative
When you add it all together , it just does n't seem worth it to me ... especially considering the prices .	__label__negative
This is the BEST Shabu-Shabu Restaurant in the Try-State Area .	__label__positive
the taste of the food and the feel of the restaurant is like being back	__label__positive
is a must for anyone who loves Shabu-Shabu .	__label__positive
The atmosphere is nothing special , but it feels	__label__positive
well and that adds to the entire ambiance .	__label__positive
Despite a slightly limited menu , everything prepared is done to perfection , ultra fresh and a work of food art .	__label__positive
I must give it Yon out of Yon stars !	__label__positive
 Taxan delicious !	__label__positive
 Taxan delicious !	__label__positive
 Taxan delicious !	__label__positive
We were n't !	__label__positive
compared to the quality of service and food .	__label__positive
We liked it so much , that we will always make it a point to dine here when we visit New York .	__label__positive
We liked it so much , that we will always make it a point to dine here when we visit New York .	__label__positive
location and ambience is Ok but the food is what makes up for it .	__label__positive
There is a lot of variety even for people who eat vegetarian like me .	__label__positive
Try green curry with vegetables .	__label__positive
The quantity is also very good , you will	__label__positive
The service is ok , some of the people	__label__neutral
I was there on sat . for my birthday and we had an excellent time .	__label__positive
I had the best ravioli ever .	__label__positive
The wine the service was very good too .	__label__positive
Moderate prices .	__label__neutral
A little noise but I think that was because of our party !	__label__neutral
A little noise but I think that was because of our party !	__label__neutral
This quaint and romantic trattoria is at the top of my Manhattan	__label__positive
delicious - from the specials to the regular menu-fare , the dishes are never a disappointment	__label__positive
's the parmesean porcini souffle or the  lamb glazed with balsamic vinega r , you will surely be transported	__label__positive
Although the tables may be closely situated , the candle-light	__label__negative
A guaranteeed delight !	__label__positive
Godfather ) has continued to serve food and  wine for the gods at mortal prices	__label__positive
If you go , try the marinara/arrabiatta sauce , the mozzarella en Carozza is mmmmmmmm ... .. everything is just delicious .	__label__positive
Check out the secret back room .	__label__positive
Check out the secret back room .	__label__positive
I pray it stays open forever .	__label__positive
Thank You Emilio .	__label__positive
Thank You Emilio .	__label__positive
I found the food , service and value exceptional everytime I have been there .	__label__positive
The food was authentic .	__label__positive
I felt as though I were eating in Paris .	__label__positive
The service was excellent - friendly and attentive .	__label__positive
The prices are wonderfully low .	__label__positive
Very good wine choices .	__label__positive
Very good wine choices .	__label__positive
has room for Cheesesticks with the best pizza in NYC !	__label__positive
the pepperoni - YUM - and a family style salad .	__label__positive
Great staff .	__label__positive
Always great service !	__label__positive
I go twice a month !	__label__positive
Fantastic !	__label__positive
The food is good , I ca n't lie	__label__positive
But the staff was so horrible to us .	__label__negative
The hostess and the waitress were incredibly rude and did everything they	__label__negative
were planning to get dessert but the waitress basically through the bill at us before	__label__negative
food is worth it ; but t he serv ice makes you feel like you should	__label__negative
Save yourself the time and trouble and skip this one !	__label__negative
Save yourself the time and trouble and skip this one !	__label__negative
 Amma is nothing special .	__label__neutral
 Amma is nothing special .	__label__neutral
here a week ago and found most dishes average at best and too expensive .	__label__negative
Will not be back .	__label__negative
simply not up to par with th e non-veg selectio ns .	__label__positive
Decor is nice though service can be spotty .	__label__negative
This place is always packed .	__label__neutral
This place is always packed .	__label__neutral
Most importantly ,  foo d is excellent .	__label__positive
Try the sea bass .	__label__positive
Highly recommended .	__label__positive
First of all Dal Bukhara Rocks .	__label__positive
First of all Dal Bukhara Rocks .	__label__positive
First of all Dal Bukhara Rocks .	__label__positive
I am happy i did the food was awsome .	__label__positive
JUST AWSOME .	__label__positive
and yes Dal Bukhara is so dam good and so are	__label__positive
and yes Dal Bukhara is so dam good and so are	__label__positive
but overall i give it a 10	__label__positive
10	__label__positive
10	__label__positive
 Haru on Park S is simply disgusting .	__label__negative
The fish was not fresh and the rice tasted old and stale .	__label__negative
, this is some of the worst  sush i I have ever tried .	__label__negative
Will never be back .	__label__negative
honestly the worst sushi my husband and i had in our	__label__negative
honestly the worst sushi my husband and i had in our	__label__negative
not sure why this restaurant would be rated that highly .	__label__negative
the all-u-can-eat sushi is definitely in very poor quality .	__label__negative
no-so-fresh ingredients , thinly-sliced fish , fall-apa rt r ice .	__label__negative
its low sodium ) , the vinegar-soak ed r ice , and the scallion on top	__label__negative
the waitstaffs are nice though .	__label__positive
wont come back again for sure !	__label__negative
I have been to Roth ' s twice and both times were very	__label__negative
I have been to Roth ' s twice and both times were very	__label__negative
times I was extremely dissappointed by the service , which was boarderline rude .	__label__negative
They wouldnt even let me finish my glass of wine before offering another .	__label__negative
Much of the time it seems like they do not care about you .	__label__negative
The dinner was ok , nothing I would have	__label__negative
I had their eggs benedict for brunch , which were the worst	__label__negative
This was a great surprise .	__label__positive
With the theater 2 blocks away we had a delicious meal in a beautiful room .	__label__positive
The service was attentive .	__label__positive
I look forward to eating here again	__label__positive
 Planet Thai is great !	__label__positive
love the food , drinks , an d atmosphe re !	__label__positive
have big group , but overall th e restaura nt is a must !	__label__positive
Try the Pad Thai , it 's fabulous and their prices are so cheap !	__label__positive
Just because it 's cheap does NOT mean the portions are small or the food is nasty , IT IS GREAT !	__label__positive
Just because it 's cheap does NOT mean the portions are small or the food is nasty , IT IS GREAT !	__label__positive
Just because it 's cheap does NOT mean the portions are small or the food is nasty , IT IS GREAT !	__label__positive
They forgot a sandwich , did n't include plastic forks , and did n't include pita with the hummus platter .	__label__negative
Also , the  sandwiche s ( nearing $ 7 ) did	__label__negative
Overall , not worth the money .	__label__negative
Eating in , the atmosphere saves it , but at your desk , it 's a very disappointing experience .	__label__negative
Eating in , the atmosphere saves it , but at your desk , it 's a very disappointing experience .	__label__negative
 Chennai Garden is my favorite Indian restaurant in the	__label__positive
They have authentic Indian at amazin prices .	__label__positive
restaurant is VEGETARIAN ; there are NO  MEAT dishe s whatsoever .	__label__negative
The seats are uncomfortable if you are sitting against	__label__negative
It 's a rather cramped and busy  restauran t and it closes early .	__label__negative
a nice cigar bar and has great staff .	__label__positive
The food is tasty and portion sizes are appropriate .	__label__positive
This is a nice restaurant if you are looking for a good	__label__positive
Not a great place for family or general dining .	__label__negative
LLOOVVE THIS PLACE .	__label__positive
 Food is excellent .	__label__positive
 Fish is so very fresh .	__label__positive
 Waitstaff are very friendly .	__label__positive
Love YUKA .	__label__positive
 Mermaid Inn is an overall good restaurant with really	__label__positive
is limited but almost all of the dishes are excellent .	__label__positive
The lobster sandwich is good and the spaghetti with Scallops and Shrimp is great .	__label__positive
The service is good and ambience is good for a date or group	__label__positive
The only fallback on this restaurant is the prices .	__label__negative
Even though its good seafood , the prices are too high .	__label__negative
The lobster sandwich is $ 24 and although it was	__label__negative
The lobster sandwich is $ 24 and although it was	__label__negative
The lobster sandwich is $ 24 and although it was	__label__negative
We were very pleasantly surprised .	__label__positive
my husband had steak ) , and the ser vice was top-notch .	__label__positive
asked for one - but because the  waite r must have seen me opening my	__label__positive
Truly the mark of an attentive waiter .	__label__positive
I highly recommend the restaurant based on our experience last night .	__label__positive
the reviews but very unhappy with the foods .	__label__negative
too much of MSG cooking in the foods .	__label__negative
too much of MSG cooking in the foods .	__label__negative
They do n't concern much of customer 's health , just want to make money .	__label__negative
please do n't fool us .	__label__negative
please do n't fool us .	__label__negative
and the soupy dumplings , certainly th e stir fry blue cr ab .	__label__positive
The food is so cheap and the waiters are nice .	__label__positive
Of course , it is crowded but who cares .	__label__neutral
Authentic Shanghai style and I can not recommend a better Shanghai place in New York .	__label__positive
frequented 'ino for several years and the food remains excellent .	__label__positive
 Cheese plate is a varied delight and great bargain	__label__positive
The large selection of bruschettas , paninis , tramezzin is keep the palate from stagnating .	__label__positive
( The  asparagus , truffle oil , parmesan brusche tta is a winner ! )	__label__positive
 Wine list is extensive without being over-priced .	__label__positive
try the seasonal , and always delicious , specia ls .	__label__positive
Definitely a neighborhood favorite .	__label__positive
I loved this place ! !	__label__positive
hesititate to write a review because the atmosphere was so great and I would hate	__label__positive
, a great deal , and th e pla ce its self was great .	__label__positive
The wait staff is very freindly , they make it	__label__positive
I like Cafe Noir dont get me wrong , it is	__label__positive
The service was terrible , we had to wait	__label__negative
The waitress , seems to be more concerned of	__label__negative
After dinner the manager grabbed my boyfriend , asked him :	__label__negative
did tip , I guess the model /waitres s just wanted more and complained to	__label__negative
up is truly unprofessional and I wish Cafe Noir would get some good staff , because	__label__positive
 Pizza here is consistently good .	__label__positive
 Salads are a delicious way to begin the	__label__positive
You should pass on the calamari .	__label__negative
It is thick and slightly soggy .	__label__negative
 Decor is charming .	__label__positive
 Service is average .	__label__neutral
What a great place .	__label__positive
What a great place .	__label__positive
on top of the fact that th e fo od was really tasty .	__label__positive
I was n't thrilled to have to wait on line for thirty minutes , but I guess that 's the price you pay for a popular place .	__label__neutral
would definitely recommend SEA if you like thai cuisine !	__label__positive
weeks back and we had the worst customer service experience at a restaurant ever .	__label__negative
A gentleman , maybe the manager , came to	__label__negative
When asked about how a certain dish was prepared in comparison to a similar at other thai restaurants , he replied this is not Mcdonald 's , every place makes things differently	__label__negative
While it is understandable that every place is indeed different , there was not a need to be uncourteous to customers and downright rude .	__label__negative
While it is understandable that every place is indeed different , there was not a need to be uncourteous to customers and downright rude .	__label__negative
Never again !	__label__negative
I absolutely Loved this place .	__label__positive
I absolutely Loved this place .	__label__positive
atmosphere , delicious dishes good and friendly  servic e .	__label__positive
this is can became on e of the NY Italian Food fare institutions .	__label__positive
I think that it is absolutely brilliant and well runned business operation .	__label__positive
The wine list is also really nice .	__label__positive
The wine list is also really nice .	__label__positive
wonderful ; food , drinks , staf f , mi leau .	__label__positive
I would highly recommend this place !	__label__positive
I have been to Casimir over 5 times and I have always	__label__positive
The food is great and reasonably priced .	__label__positive
reservations , but both times , th e hoste ss did n't have my name .	__label__negative
is nice , try to snag an  outside tabl e .	__label__positive
but they seemed really stressed and the  unisex bathroo m needs to be cleaned more often	__label__negative
My boyfriend and I went there to celebrate my birthday the other night and all I can say is that it was magnificent .	__label__positive
From the spectacular caviar to the hospitable waitstaff , I felt like royalty and enjoyed	__label__positive
was after the closing time , the  waitstaf f did not rush us at all	__label__positive
wants delicious top grade caviar and fantastic service .	__label__positive
Nice Family owned traditional restaurant .	__label__positive
Fresh ingredients and everything is made to order .	__label__positive
I was pleasantly surprised to find this gem in Hoboken .	__label__positive
Friendly staff that actually lets you enjoy your meal	__label__positive
Friendly staff that actually lets you enjoy your meal	__label__positive
food to be outstanding , particulary the  salmon dis h I had .	__label__positive
I also ordered the Change Mojito , which was out of this world	__label__positive
back the following day to try the  dim su m , which was good ... not	__label__neutral
it as it 's cool and th e mus ic is hear well there .	__label__positive
Overall , excellent  restauran t !	__label__positive
Overall , excellent  restauran t !	__label__positive
The food was good .	__label__positive
The place was nice and calm .	__label__positive
but the service was a bit slow .	__label__negative
but the service was a bit slow .	__label__negative
The buffet had a nice selection .	__label__positive
average or above including some surprising tasty dishes .	__label__positive
 Service was also very good .	__label__positive
I would go back .	__label__positive
cheesecake and we had several other nice pastries .	__label__positive
I would recommend Roxy 's for that , but not for their food .	__label__positive
My son and his girlfriend both wanted cheeseburgers and they were huge !	__label__neutral
But , they were too big for the bun .	__label__negative
Consequently , their  burger s fell apart in their hands and	__label__negative
Also they were $ 15 each !	__label__negative
I had a huge pastrami sandwich on a roll .	__label__neutral
It was $ 14 not really bad for a pound of Pastrami-but it did n't have much taste-I 've had better for less elsewhere !	__label__negative
This place is really trendi but they have forgotten	__label__positive
could barely eat it , and the spice took away from the flavor of the	__label__negative
And the Tom Kha soup was pathetic .	__label__negative
If you want good authentic Thai this place is not the place to	__label__negative
and I was thoroughly impressed with the  foo d .	__label__positive
thin-crust pizza with a nice amount of  spicy Italian chees e that I 'd never heard of	__label__positive
Conveniently located too , being right on Bedford ave .	__label__positive
THe back garden sitting area is very pleasant , where you can	__label__positive
I will definetly be going back .	__label__positive
We had the lobster sandwich and it was FANTASTIC .	__label__positive
for me he even exclaimed that th e french fri es were the best he has had	__label__positive
appetizer and they were delicious and the sauce was wonderful .	__label__positive
appetizer and they were delicious and the sauce was wonderful .	__label__positive
We waited at the bar and had martinis that were just right .	__label__positive
We will be back .	__label__positive
love the food .	__label__positive
only place you can get yummy authentic  japanese comfort foo d .	__label__positive
only place you can get yummy authentic  japanese comfort foo d .	__label__positive
and you ca n't beat the prices .	__label__positive
highly recommended .	__label__positive
in NY for 5 years and this  plac e has it all .	__label__positive
menu , great service and an unpretensiou s setti ng .	__label__positive
, large whole shrimp to the amazi ng pistachio ice cr eam ( the best and freshest I	__label__positive
'm glad I was introduced to this  plac e and this is a rare gem	__label__positive
'm glad I was introduced to this  plac e and this is a rare gem	__label__positive
, best variety , and the fastes t delive ry .	__label__positive
Also very inexpensive .	__label__positive
A great choice at any cost and a great deal .	__label__positive
The service was excellent and the food was delicious .	__label__positive
rolls , two types of sake , and the banana tempura .	__label__positive
rolls , two types of sake , and the banana tempura .	__label__positive
Definitely a great spot for a nice occasion or date .	__label__positive
to good Thai food , but terrible  deliver y .	__label__negative
I 've waited over one hour for food .	__label__negative
They were very abrupt with me when I called and actually claimed the food was late because they were out of rice .	__label__negative
A Thai restaurant out of rice during dinner ?	__label__negative
The food arrived 20 minutes after I called , cold and soggy .	__label__negative
The food arrived 20 minutes after I called , cold and soggy .	__label__negative
This is a wonderful place on all stand points especially value ofr	__label__positive
An excellent service 	__label__positive
An excellent service 	__label__positive
We were greeted promptly by the waiter who was very nice and cordial .	__label__positive
us in ordering a lot of good dishes since we knew nothing about Indian food	__label__positive
us in ordering a lot of good dishes since we knew nothing about Indian food	__label__positive
The food looked very appetizing and delicious since it	__label__positive
We ended our great experience by having Gulab Jamun ( dessert ) recommended by the waiter .	__label__positive
thanked my friend who recommended me this restaurant and will certainly recommend it to others	__label__positive
thanked my friend who recommended me this restaurant and will certainly recommend it to others	__label__positive
Service here was great ,  foo d was fantastic .	__label__positive
very good , did n't much like the fr ites that came with , but the	__label__negative
Will absolutely visit again .	__label__positive
Will absolutely visit again .	__label__positive
You can not go wrong with this  plac e .	__label__positive
The food is outstanding and the service is quick , friendly and very professional	__label__positive
Always a nice crowd , but never loud .	__label__positive
Go here .	__label__positive
Good for dates or with friends .	__label__positive
would not want my jem of a pizza place to become overcrowded .	__label__positive
However , it is jus too good to not praise it .	__label__positive
By far , the best  pizz a in Manhattan .	__label__positive
The crust is thin , the  ingredient s are fresh and the staff is	__label__positive
The crust is thin , the  ingredient s are fresh and the staff is	__label__positive
The crust is thin , the  ingredient s are fresh and the staff is	__label__positive
The crust is thin , the  ingredient s are fresh and the staff is	__label__positive
The menu has so many fish items and oysters	__label__positive
The menu has so many fish items and oysters	__label__positive
The fish was really , really fresh .	__label__positive
The fish was really , really fresh .	__label__positive
We all agreed that mare is one of the best seafood restaurants	__label__positive
I stumbled upon this great pizzeria as I explored my new neighborhood .	__label__positive
All of the pizzas are terrific and the price is even better !	__label__positive
I highly recommend the Sophia pizza .	__label__positive
It 's to die for !	__label__positive
at best but it was the horrible service that made me vow never to go	__label__negative
Immediately after we paid , the  waite r took the money and said ,	__label__negative
Immediately after we paid , the  waite r took the money and said ,	__label__negative
Immediately after we paid , the  waite r took the money and said ,	__label__negative
Immediately after we paid , the  waite r took the money and said ,	__label__negative
Immediately after we paid , the  waite r took the money and said ,	__label__negative
So rushing us out was absolutely unnecessary !	__label__negative
people who want great food plus great service , Roxy is a place to AVOID	__label__negative
people who want great food plus great service , Roxy is a place to AVOID	__label__negative
The first time the sushi was outstanding , the second time it	__label__negative
I 'm sure I 'll return for a final judgement tho .	__label__neutral
the premium sake is excellent and the  servic e is great .	__label__positive
 Mizu is the Japenese find in Grammercy .	__label__positive
their kitchen food is delicious , their  Sush i is out of this world .	__label__positive
Mizu is home to creative and unique rolls not to found anywhere else .	__label__positive
the cuisine the best around , the  servic e has always been attentive and charming	__label__positive
other Japanese restaurants after a visit to  Miz u !	__label__positive
 Thalia is a beautiful restaurant with beautiful people	__label__positive
I ordered the smoked salmon and roe appetizer and it was off flavor .	__label__negative
The entree was bland and small ,  desser t was not inspired .	__label__negative
a bit more from such an expensive menu .	__label__negative
The view is spectacular , and the  foo d is great .	__label__positive
Wonderful strawberry daiquiries as well !	__label__positive
Definitely worth the trip to Battery Park City !	__label__positive
One of my favorite places in Manhattan .	__label__positive
Authentic Taiwanese food that 's cheap ... what more could	__label__positive
( Besides that there should be more restaurants like it around the city ) .	__label__positive
The cold appetizer dishes taste like the way I remember them	__label__positive
delicious simple food in nice outdoor atmosphere .	__label__positive
Kind , attentive  wait staf f .	__label__positive
really like both the scallops and the mahi mahi ( on saffron risott o-yum ! ) .	__label__positive
My friend devoured her chicken and mashed potatos .	__label__positive
Delicious crab cakes too .	__label__positive
Even if the food was n't this good , the garden	__label__positive
Great neighborhood joint .	__label__positive
selection of thin crust pizza including the Basil slice .	__label__positive
Their calzones are horrific , bad , vomit-inducing ,	__label__negative
They smell like they stuff them with old canned vegetables like the spinach mushroom calzone .	__label__negative
The counter service is bad .	__label__negative
They charge different prices all the time .	__label__negative
They 're rude at times , and not very friendly .	__label__negative
NO PIZZA 33 for me !	__label__negative
Anybody who likes this place must be from a different planet , where greasy , dry and tasteless are complimentary .	__label__negative
The dosas are skimpy , unattractive and drip with	__label__negative
The sandwiches are dry , tasteless and way overpriced	__label__negative
but in this unattractive room with unhelpful  clerk s there was a dearth of the	__label__negative
Seriously , this  plac e kicks ass .	__label__positive
, the service impecible , and th e fo od magnificant .	__label__positive
Best Italian food I ever had ( and being Italian	__label__positive
It is nearly impossible to get a table , so if you ever have the chance to go here for dinner , DO NOT pass it up .	__label__positive
This is such a lovely , peaceful  plac e to eat outside .	__label__positive
The restaurant looks out over beautiful green lawns to	__label__positive
It is set far from the small street it 's on , and there is no traffic noise .	__label__positive
their more basic dishes , and th e drin ks are delicious .	__label__positive
This is a great place to take out-of-towners , and perfect for	__label__positive
Great sushi experience .	__label__positive
Nice value .	__label__positive
Unique apppetizers .	__label__positive
Try sushimi cucumber roll .	__label__positive
Good spreads , great beverage selections and  bagel s really tasty .	__label__positive
THE BIG COMPLAINT : NO TOASTING AVAILABLE .	__label__negative
THE BIG COMPLAINT : NO TOASTING AVAILABLE .	__label__negative
Murray wo n't do it .	__label__negative
Murray wo n't do it .	__label__negative
who says Murray 's is anything about  servic e .	__label__negative
So close , but not good enough .	__label__neutral
Do n't be fooled by crowds of people .	__label__negative
The service is awful .	__label__negative
This place is not worth the prices .	__label__negative
Also , do n't plan on asking for your favorite roll , if it 's not on the menu , you ca n't have it .	__label__negative
Love Pizza 33 ..	__label__positive
I only crave one thing ... their  Pizz a .	__label__positive
I only crave one thing ... their  Pizz a .	__label__positive
It hits the spot every time	__label__positive
This tiny Williamsburg spot is always pleasantly surprising .	__label__positive
The pizza is delicious and the proprietor is one of the nicest in NYC	__label__positive
The pizza is delicious and the proprietor is one of the nicest in NYC	__label__positive
I 've been many time and have never been disappointed .	__label__positive
I 've been many time and have never been disappointed .	__label__positive
They even scoop it out nice ( for those on a diet ) not too much not to little .	__label__positive
of this world and I love that coffee ! !	__label__positive
A little crowded but they move that line really fast !	__label__negative
A little pricey but it really hits the spot on a Sunday morning !	__label__positive
Bagels are ok , but be sure not to make any special requests !	__label__negative
an open faced cheese sandwich and the manager basically told me to take my business	__label__negative
sure not to get anything other than bagels ! ..	__label__positive
the turkey burgers are scary !	__label__negative
The worst excuse for Japanese food I 've ever encountered .	__label__negative
The soup for the udon was soy sauce and water .	__label__negative
The sushi was awful !	__label__negative
The rice was poor quality and was cooked so	__label__negative
rice had no seasoning , so th e sus hi was bland and disgusting .	__label__negative
The fish was adequate , but inexpertly sliced .	__label__negative
has any idea about or experience with Japanese cuisine .	__label__negative
Good , fast  servic e .	__label__positive
I would highly recommend .	__label__positive
 Food is great and inexpensive .	__label__positive
The location is perfect .	__label__positive
Give it a try and enjoy .	__label__positive
Give it a try and enjoy .	__label__positive
Give it a try and enjoy .	__label__positive
Well , this  plac e is so Ghetto its not even	__label__negative
If you like your music blasted and the system isnt that great	__label__negative
Would NEVER go back there .	__label__negative
Would NEVER go back there .	__label__negative
Would NEVER go back there .	__label__negative
Awsome Pizza especially the Margheritta slice .	__label__positive
Always busy but fast moving .	__label__positive
Great atmoshere and worth every bit .	__label__positive
Open late ( well as late as I ever got there and I 'm a night person )	__label__positive
 Winnie and her staff are the best crew	__label__positive
The food is reliable and the price is moderate .	__label__neutral
What more can you ask for ?	__label__positive
For authentic Thai food , look no further than Toons .	__label__positive
For authentic Thai food , look no further than Toons .	__label__positive
Thai , or sample anything on the  appetizer men u ... they 're all delicious .	__label__positive
Everything about this restaurant was special .	__label__positive
The service was attentive , yet discreet .	__label__positive
The flavors robust and subtle .	__label__positive
The brioche and lollies as party favors is a cute and	__label__positive
I 'm saving up for my next visit .	__label__positive
I 'm saving up for my next visit .	__label__positive
The place was quiet and delightful .	__label__positive
Service was good and food is wonderful .	__label__positive
caviar but I tried their salmon and crab salad ( they are all good )	__label__positive
It is definitely a good spot for snacks and chat .	__label__positive
of certainty that for the last year  Lucky Strik e has been the best laid-back late	__label__positive
The wait staff is pleasant , fun , and for	__label__positive
spicy tomato sauce and their shoestring crispy  frie s .	__label__positive
the best part about LS is the late night atmosphere , delightfully free of the BTs .	__label__positive
) in a great homey setting wit h gre at music .	__label__positive
The in-house lady DJ on Saturday nights has outrageously good taste	__label__positive
You ca n't go wrong with this  plac e .	__label__positive
 Suan is a great place that I often	__label__positive
reasonable , makes students go back to  Sua n again and again .	__label__positive
I LOVE their Thai 	__label__positive
 noodles with shrimp and chicken and coconut juice is the MUST !	__label__positive
 noodles with shrimp and chicken and coconut juice is the MUST !	__label__positive
I will go back to Suan soon !	__label__positive
In summer-eat outside on a terrace ( another great feature of Suan )	__label__positive
I can not imagine a friendlier  staf f working in a restaurant .	__label__positive
I can not imagine better  Indian foo d in all of the city .	__label__positive
I can not imagine you not rushing out to eat there .	__label__positive
I can not imagine you not rushing out to eat there .	__label__positive
past 3 months , the chef and  staf f changed and it was not for	__label__negative
I wish they would change back to what it was before .	__label__negative
The food now is inconsistent .	__label__negative
This is the kind of place you 'd like to take all your	__label__positive
The setting is casual and romantic .	__label__positive
Prices are very good .	__label__positive
The food is excellent !	__label__positive
if you 're daring , try th e balsamic vinegar over icecre am , it 's wonderful !	__label__positive
Do not get the Go Go Hamburgers , no matter what the reviews say	__label__negative
They were such a rip-off ( $ 8.95 for four small meat patties in steamed buns ) and not worth trying .	__label__negative
The rest of the dim sum , though pricey by Chinatown standards ,	__label__positive
Steamed fresh so brought hot hot hot to your table .	__label__positive
The wait here is long for dim sum , but if you do n't like sharing tables or if the typical raucous dim sum atmosphere is not your gig , this is a sleek ( for Chinatown ) alternative .	__label__negative
turnip cake , roast pork buns an d egg custar ds .	__label__negative
These are overpriced and you can get better just around the corner :	__label__negative
These are overpriced and you can get better just around the corner :	__label__negative
These are overpriced and you can get better just around the corner :	__label__negative
These are overpriced and you can get better just around the corner :	__label__negative
I was pleasantly suprised .	__label__positive
The food was exceptional .	__label__positive
The food was exceptional .	__label__positive
with one of the special , the  braised lamb shank in red win e , which was excellent .	__label__positive
The service was friendly and the atmosphere was casual .	__label__neutral
The restaurant is a bit noisy but that is	__label__negative
this little place has a cute interior decor and affordable	__label__positive
ew chicken was delicious , however the  pad tha i was far too oily .	__label__negative
ew chicken was delicious , however the  pad tha i was far too oily .	__label__negative
Have eaten at Ginger House several times , and it 's always	__label__positive
The fried dumplings are GREAT !	__label__positive
Finally a reliable Chinese restaurant !	__label__positive
run by a group that actually understands customer service .	__label__negative
run by a group that actually understands customer service .	__label__negative
They are not helpful in the least and will give you the grand run around so by the time the event date rolls around you will not only regret chosing this place , but also become hostile !	__label__negative
Nobody at this restaurant will give firm answers about anything and in the end , not one person takes responsibility for anything .	__label__negative
Terrible , terrible management - deserves to be shut-down .	__label__negative
Never fails to please .	__label__positive
delicious bagels , especially when right out of the	__label__positive
Spreads and toppings are great - though a bit pricey	__label__negative
 Service is fast and friendly .	__label__positive
Only drawback - they wo n't toast your bagel , and they do n't make eggs for the bagel .	__label__negative
But that is highly forgivable .	__label__positive
But that is highly forgivable .	__label__positive
is decent at best , and the  ambienc e , well , it 's a	__label__negative
If celebrities make you sweat , then your in for a ride , but if your like most around these parts then you 'll just yawn and wonder whats with all the hype .	__label__negative
 Rao is a good restaurant , but it	__label__neutral
 Rao is a good restaurant , but it	__label__neutral
is the only place I 'm eatin g indian cuisi ne .	__label__positive
You must try the shrimp appetizers .	__label__positive
Even my Indian friend could n't believe how good and tasty everything was .	__label__positive
the the correct ambience and an excellent staff to make you feel like a guest	__label__positive
Great food , great prices , grea t servi ce .	__label__positive
looking for a good quality , cheap  eat s - this is the place .	__label__positive
a perfect place to have a amanzing  indian foo d .	__label__positive
different and inovated touch that 's the  chef f gives to the food .	__label__positive
very romantic and confortable place , th e servi ce it 's just perfect ... they	__label__positive
very romantic and confortable place , th e servi ce it 's just perfect ... they	__label__positive
Their bagels are fine , but they are a	__label__negative
Their bagels are fine , but they are a	__label__negative
Their bagels are fine , but they are a	__label__negative
Great bagels made the old-fashioned way .	__label__positive
Great bagels made the old-fashioned way .	__label__positive
Drawbacks :  servic e is slow and they do n't	__label__negative
The food was absolutely amazing ! !	__label__positive
The baked clams octopus we shared as appetizers were the best	__label__positive
tender so full of flavor , the  desser t was divine ! !	__label__positive
The waiter was attentive .	__label__positive
The place itself is beautiful the bar scene seems to be happening .	__label__positive
, waiter gave me poor suggestion..try th e potato stuff kani sh best one .	__label__positive
Small servings for main entree , i had salmon ( wasnt impressed	__label__negative
 Dessert is a joke ... dont bother	__label__negative
ask for more than that when th e servi ce is this friendly .	__label__positive
the portions which are enormous ; th e ve al alone could have single-handedly solved third	__label__positive
the calamari , as were the fillin g pasta mai ns .	__label__positive
easily hike up an otherwise reasonably priced meal .	__label__positive
the bill were off-set by the pour-your-own  measures of liquer s which were courtesey of the house	__label__positive
Fantastic place .	__label__positive
Cute and decorative .	__label__positive
A pleasant surprise .	__label__positive
Go there to relax and feel like your somewhere else .	__label__positive
 Lucky Strike is a great casual place to just	__label__positive
 Lucky Strike is a great casual place to just	__label__positive
Great food , great decor , grea t servi ce .	__label__positive
I recommend it !	__label__positive
I recommend it !	__label__positive
This is the perfect spot for meeting friends , having lunch ,	__label__positive
( Always ask the bartender for the  SEASONAL bee r ! ! !	__label__positive
Guaranteed to be a tasty experience ! )	__label__positive
Excellent spot for holiday get togethers with co-workers or	__label__positive
doing all of the above at the Heartland Brewery for over 5 years now and I	__label__positive
All the people that I bring there go back on their own and bring THEIR friends !	__label__positive
Go there once and oh yes ... you will go back ... you will ...	__label__positive
What a great place !	__label__positive
Not the typical NYC gimmick theme restaurant .	__label__positive
great food , and tons of excellent  bee r .	__label__positive
And even with it 's Pub atmosphere they were great to my kids too !	__label__positive
Loved it !	__label__positive
Loved it !	__label__positive
The shrimp scampi was excellent and the antipasti were plentiful .	__label__positive
It is expensive but well worth the money .	__label__positive
a great Italian restaurant , drive t o Coro na .	__label__positive
( which is exceptional ) is th e servi ce .	__label__positive
The only thing the waiters do n't do for you is wipe	__label__positive
Wonderful at holiday time .	__label__positive
Cozy romantic atomosphere with only around 15 tables at most	__label__positive
 Service was very prompt but slightly rushed .	__label__positive
 Food was very good , but not what	__label__neutral
Go here for a romantic dinner but not for an all out wow dining experience .	__label__negative
My friend from Milan and myself were pleasantly surprised when we arrived and everyone spoke italian .	__label__positive
Too bad the food was n't of the same heritage .	__label__negative
special was tasteless , so was the  seafood tagliatell e .	__label__negative
A real dissapointment .	__label__negative
n't the icing on the cake : a tirami su that resembled nothing I have ever	__label__negative
They should have called it mascarpone with chocolate chips-good but a far cry from what the name implies .	__label__negative
Priced at upper intermediate range .	__label__negative
I really liked this place .	__label__positive
Everything I had was good , and I 'm a eater .	__label__positive
It was pretty inexpensive too .	__label__positive
This place has the best Chinese style BBQ ribs in the city .	__label__positive
rice dishes or the different varieties of congee ( rice porridge ) .	__label__positive
It 's great to go for a quick lunch either alone or with a friend .	__label__positive
It 's definately not a  plac e to go if you want to	__label__negative
However , if you want great  foo d at a great price and do	__label__positive
Quick and friendly service .	__label__positive
This is one of the best comfort food places in the city .	__label__positive
It 's somewhere you can eat and be happy .	__label__positive
It 's somewhere you can eat and be happy .	__label__positive
which has a spectacular , hand-painted hi gh ceil ing ) you 'd never know there	__label__positive
, tasty and filling , and th e servi ce is professional and friendly .	__label__positive
when they serve outside on their giganti c pat io .	__label__positive
when they serve outside on their giganti c pat io .	__label__positive
I recently tried Suan and I thought that it was great	__label__positive
and you sure get a lot of food for your money .	__label__positive
very tasty and they had the best hot sauce to add to your meals .	__label__positive
I have to say that I am pleasantly suprised and I will most likely stop in again if I am in the neighborhood .	__label__positive
They all know you .	__label__positive
Good food .	__label__positive
Good drink .	__label__positive
How do you rate home ?	__label__positive
I have never had cheescake like this .	__label__positive
I thought I had died and gone to heaven .	__label__positive
Great spot , whether looking for a couple of	__label__positive
and friendly in the winter and terrific outdoor seating in the warmer months .	__label__positive
and they have a good selecion of wines at reasonable prices .	__label__positive
Have been several times and it never dissapoints .	__label__positive
Have been several times and it never dissapoints .	__label__positive
We were less than impressed .	__label__negative
atmosphere were great , the food and  servic e could have been a lot better	__label__negative
We ordered the chicken casserole , but what we got were a	__label__negative
Probably would not go again ...	__label__negative
to sapphire twice and both times the  foo d was fine , if not good	__label__positive
with the chicken , beef , an d lamb dish es .	__label__positive
with the chicken , beef , an d lamb dish es .	__label__positive
with the chicken , beef , an d lamb dish es .	__label__positive
service is friendly , and never had a problem walking in and getting a table .	__label__positive
service is friendly , and never had a problem walking in and getting a table .	__label__positive
skip dessert .	__label__negative
Best Reuben sandwich ever !	__label__positive
A classic !	__label__positive
Do n't miss  Bloom  's on your next trip to Manhatten	__label__positive
, and it will be the last  plac e we stop as we head out	__label__positive
Thanks Bloom ' s for a lovely trip .	__label__positive
Thanks Bloom ' s for a lovely trip .	__label__positive
The food was not fresh , the  sauce s were bland and very oily .	__label__negative
It just was n't Thai .	__label__negative
It just was n't Thai .	__label__negative
Was surprisingly disappointed .	__label__negative
 Pizza was a little soggy .	__label__negative
Ravioli was good ... but I have to say that I found everything a bit overpriced .	__label__negative
Not enough wines by the glass either .	__label__negative
, was excellent ... and I liked the setting/atmosp here a lot .	__label__positive
Food was just average ... if they lowered the prices just a bit , it would be a bigger draw .	__label__negative
This place is a great bargain .	__label__positive
Authentic Pakistani food .	__label__positive
 People are always friendly .	__label__positive
 People are always friendly .	__label__positive
Just straight up cheap , good  foo d .	__label__positive
 Faan is sooo good .	__label__positive
The best pad thai i 've ever had .	__label__positive
The design and atmosphere is just as good .	__label__positive
 bottles of wine are cheap and good .	__label__positive
What more could you want ?	__label__positive
The food was actually aweful .	__label__negative
I 'm not picky - but it was actually gross .	__label__negative
The mussles were the fishiest things I 've ever tasted , the seabass was bland , the goat cheese salad was missing the goat cheese , the penne w/ chicken had bones in it ... It was disgusting .	__label__negative
the service was very pleasant and the  deser t was good .	__label__positive
Would n't recomend it for dinner !	__label__negative
This is the perfect date spot for Williamsburg couples .	__label__positive
The jukebox plays everything from Italian Opera to The	__label__positive
amazing , rich pastas and fresh doughy  pizz a .	__label__positive
, the owner is super friendly and  servic e is fast .	__label__positive
If only they delivered , they 'd make a mint !	__label__neutral
go here for the drinks !	__label__positive
go here for the drinks !	__label__positive
go here for the drinks !	__label__positive
the drinks are amazing and half off till 8pm	__label__positive
Ask for Usha , the nicest bartender in manhattan .	__label__positive
My fav was the sassy lassi ...	__label__positive
is an amazing place to try some roti rolls .	__label__positive
I really recommend the very simple Unda ( Egg ) rol ls .	__label__positive
, onions , eggs and a kick-as s ro ti .	__label__positive
Amazing !	__label__positive
 Toons has recently been redone , so it	__label__positive
The food 's as good as ever .	__label__positive
In an area sadly lacking in decent Thai food , this is one of the best	__label__positive
decor , good service , but th e fo od was surprisingly excellent .	__label__positive
The portions are HUGE , so it might be	__label__neutral
The portions are HUGE , so it might be	__label__neutral
Ca n't wait to go back .	__label__positive
Best drumsticks over rice and sour spicy soup in town !	__label__positive
 Beef noodle soup is good as well .	__label__positive
The service is good and the resturant is clean .	__label__positive
Best Taiwanese food in NY !	__label__positive
I have been to Rao ' s probably 15 times the past 3	__label__positive
For those that go once and do n't enjoy it , all I can say is that they just do n't get it .	__label__positive
Rao 's has the best service and  atmospher e in NYC .	__label__positive
Good luck getting a table .	__label__negative
My roommate and I LOVE this place .	__label__positive
and to our delight , they hav e outdoor seati ng , perfect since I had my	__label__positive
 Indoor was very cozy and cute .	__label__positive
sizes here are huge , and the  sush i is good .	__label__positive
sizes here are huge , and the  sush i is good .	__label__positive
 Staff is very accomodating .	__label__positive
Excellent dumplings served amid clean , chic  deco r .	__label__positive
I got the $ 10 10-piece dim sum comb o , every bite of which was	__label__positive
But $ 1 for each small piece ? ? ?	__label__negative
Not worth it .	__label__negative
I wo n't go back unless someone else is footing the bill .	__label__negative
I wo n't go back unless someone else is footing the bill .	__label__negative
The decor is very simple but comfortable .	__label__positive
The food was delicious but do not come here	__label__negative
portions are small but being that the food was so good makes up for that	__label__positive
is out of this world and the chocolate bread pudding for dessert .	__label__positive
The staff there is very attentive and down to	__label__positive
I loved it and would go again .	__label__positive
Great Indian food and the service is incredible .	__label__positive
The owner truly caters to all your needs .	__label__positive
When family came in he gave them apps to test their palets , and then ordered for them .	__label__positive
Everyone was more then happy with his choices .	__label__positive
Great food and the prices are very reasonable .	__label__positive
Great food and the prices are very reasonable .	__label__positive
The food here does a great service to the	__label__positive
I fell in love with the egg noodles in the beef broth with shrimp dumplings and slices of BBQ roast pork .	__label__positive
This dish is my favorite and I always get	__label__positive
donut like deep fried dough they call Ow Ley Soh , a delicious and sweet tasting bread	__label__positive
Simply some good tasting Chinese food at incredible prices ...	__label__positive
 Service is not what you are coming here	__label__negative
 Service is not what you are coming here	__label__negative
 Big Wong is a great place to eat and	__label__positive
 Big Wong is a great place to eat and	__label__positive
whoever the jazz duo was , they were on POINT .	__label__positive
good music , great food , speedy service affordable prices .	__label__positive
even the wine by the glass was good .	__label__positive
its a little out of the way if you do n't live in the neighborhood , but definitely worth the trip from wherever you are .	__label__positive
Consistently good Japanese Tapas .	__label__positive
Consistently good Japanese Tapas .	__label__positive
Always good drinks and service is pretty good ;	__label__positive
 Atmosphere is nice and relaxed too ...	__label__positive
A great place to meet up for some food and	__label__positive
 Yakitori ( bbq meats ) is tasty too .	__label__positive
 Yakitori ( bbq meats ) is tasty too .	__label__positive
 Yakitori ( bbq meats ) is tasty too .	__label__positive
low quality fish , unfriendly staff and a sushi ch ef that looks like he is miserable	__label__negative
Price and quality of fish alone will keep us from making a return visit .	__label__negative
the sushi bar dining we watched t he c hef accidentally drop a piece of Unagi	__label__negative
No thanks ! ! !	__label__negative
This place , which is only a few months	__label__positive
spend most of your time in Manh attan , Ric e Avenue will make you feel at	__label__positive
We were seated outside and the waiter spilled red wine and hot tea on	__label__negative
We were then shooed inside .	__label__negative
- instead , we got a snobb y wait er would n't even take our order	__label__negative
We left , never to return .	__label__negative
at a glorified diner , clumsy service , and mana gement that does n't care .	__label__negative
with the service and I thought the food was overated and on the pricey side	__label__negative
with the service and I thought the food was overated and on the pricey side	__label__negative
with the service and I thought the food was overated and on the pricey side	__label__negative
with the service and I thought the food was overated and on the pricey side	__label__negative
with the service and I thought the food was overated and on the pricey side	__label__negative
The food is okay and the prices here are mediocre .	__label__neutral
The food is okay and the prices here are mediocre .	__label__neutral
The food is okay and the prices here are mediocre .	__label__neutral
 Baluchi ' s has solid food and a nice	__label__positive
The only problem is that the manager is a complete incompetent .	__label__negative
He offers subpar service and has no personality .	__label__negative
In fact , it appears he is going to go postal at any moment .	__label__negative
In fact , it appears he is going to go postal at any moment .	__label__negative
There is no excuse for such lousy service !	__label__negative
before eaten 40 pieces of relatively good nigiri .	__label__neutral
before eaten 40 pieces of relatively good nigiri .	__label__neutral
You can do it here .	__label__positive
$ 20 for  all you can eat sush i can not be beaten .	__label__positive
I went to Areo on a Sunday afternoon with four of	__label__positive
I went to Areo on a Sunday afternoon with four of	__label__positive
Most of the servers are very attentive , friendly and quite	__label__positive
Most of the servers are very attentive , friendly and quite	__label__positive
cozy , service was great and the  foo d was excellent !	__label__positive
Me and my girls will definitely go back .	__label__positive
Food was good and the view of the new york city skiline was terrific even on a foggy rainy	__label__positive
I would highly recommand requesting a table by the window .	__label__positive
was good and overall very relaxing to place to eat .	__label__positive
was good and overall very relaxing to place to eat .	__label__positive
The food is great .	__label__positive
 Personal pans are the perfect size for those hungry	__label__positive
I heartily recommend .	__label__positive
if you 're ordering in -- the  delivery guy s have MAJOR attitude .	__label__negative
Never have I had such dramatic delivery guys ( a lot of huffing and panting	__label__negative
Never have I had such dramatic delivery guys ( a lot of huffing and panting	__label__negative
and nice light to it..very fortunate ,  locatio n wise .	__label__positive
The pizza was pretty good and huge .	__label__positive
The price very reasonable .	__label__positive
were 4 and got the family size penne a la vodka which was tremendously gigantic portion ... a	__label__positive
were 4 and got the family size penne a la vodka which was tremendously gigantic portion ... a	__label__positive
I would say that all was fine and tasty but the heaviness on my stomach someting that i ca n't not mention or undermine .	__label__negative
The pasta penne was pretty extra buttery , creamy which	__label__negative
The pasta penne was pretty extra buttery , creamy which	__label__negative
The pasta penne was pretty extra buttery , creamy which	__label__negative
 La Rosa waltzes in , and I think they	__label__positive
Interesting selection , good wines , service fine ,	__label__positive
Interesting selection , good wines , service fine ,	__label__positive
I love it .	__label__positive
I plan on stopping by next week as well .	__label__positive
on a cold night , the perfect  spo t to warm up .	__label__positive
I recieved prompt service with a smile .	__label__positive
To me it exemplifies Soho , cute , artsy , interesting .	__label__positive
Definately check it out ! ! !	__label__positive
This place blew me away ... by far my	__label__positive
The wine list is extensive and impressive .	__label__positive
LOVE the atmosphere - felt like I was in Paris	__label__positive
The mussels were fantastic and so was the dessert ... definitely going to be back very soon .	__label__positive
The mussels were fantastic and so was the dessert ... definitely going to be back very soon .	__label__positive
say about the service and the great staff at La Lanterna .	__label__positive
the host , Vittorio , and hi s cr ew , have always treated me as	__label__positive
Best Thin Crust Pizzas , and n ow a Lasagna Menu which is to die for (	__label__positive
I lOVE THIS PLACE !	__label__positive
Keep up the good work guys !	__label__positive
Keep up the good work guys !	__label__positive
say I have never had a disapointing meal here .	__label__positive
have made a meal of the yummy dumplings from the dumpling menu .	__label__positive
the BBQ Salmon , Sea Bass and  Crispy Duc k .	__label__positive
the BBQ Salmon , Sea Bass and  Crispy Duc k .	__label__positive
